#src	target
对台湾的大学制度和社会血管而言，学生要工作的话很难，要辨读大学边工作的话，这会逼迫学生工作和学习上分心，让学生陷于力不从心精神分散的恶境。	对台湾的大学制度和社会血管而言，学生要工作的话很难，要边读大学边工作的话，这会逼迫学生工作和学习上分心，让学生陷于力不从心精神分散的恶境。
而大众对于其好坏方面的比例又不同的判断，所以对其的态度也完全不一至。	而大众对于其好坏方面的比例有不同的判断，所以对其的态度也完全不一致。
怎么办！我的房子里大学很远！时间不够了！	怎么办！我的房子离大学很远！时间不够了！
所以老师们应该这导最好交孩子的方法就是让他们玩儿而发展。	所以老师们应该知道最好教孩子的方法就是让他们玩儿而发展。
搭进第二十一世纪，顺著社会、科学的进步，网路科学也不断地发展同时电脑领域也速步地更新。	踏进第二十一世纪，顺著社会、科学的进步，网路科学也不断地发展同时电脑领域也速步地更新。
因为现在，我们再得这一时代，就是不能相信别人家的很冷淡的时代嘛！	因为现在，我们在的这一时代，就是不能相信别人家的很冷淡的时代嘛！
好可惜我下个礼拜要回国，我已经买过飞机票所以没办法那天跟你们一起庆祝你们的寰麟。	好可惜我下个礼拜要回国，我已经买过飞机票所以没办法那天跟你们一起庆祝你们的婚礼。
请你先不要放弃！你可以利用在家理的时间想一想你未来最想要做的是什么？	请你先不要放弃！你可以利用在家里的时间想一想你未来最想要做的是什么？
「宠物出租」我看在都市区会受欢迎。老实说我想各各人应该要考虑之后养动物才对。	「宠物出租」我看在都市区会受欢迎。老实说我想各个人应该要考虑之后养动物才对。
到了学校一后，他跟他的同学一起上数学科。	到了学校以后，他跟他的同学一起上数学课。
辛亏我的行业被目前的经济衰退只是所掠过得而已。	幸亏我的行业被目前的经济衰退只是所掠过的而已。
如果贵工厂在段时间内未改善，不肯处理！我们只好寻求公家单位来解决，甚至法律途径！	如果贵工厂在短时间内未改善，不肯处理！我们只好寻求公家单位来解决，甚至法律途径！
今天给您写了一封信，希望您赶快找处理让我们可以睡个饱觉。	今天给您写了一封信，希望您赶快早处理让我们可以睡个饱觉。
可是，不是每个家长都闲这时时刻刻可以登入网上看孩子的情况。	可是，不是每个家长都闲著时时刻刻可以登入网上看孩子的情况。
因为你不是住在工商，只来工商工作而已，你可能不知道我们的生活困难。	因为你不是住在工厂，只来工商工作而已，你可能不知道我们的生活困难。
在上班的时候会专心地工作，回家后也会付出了很多爱心给物。	在上班的时候会专心地工作，回家后也会付出了很多爱心给牠。
搞不好这就是让孩子成为两种人格的人格体，机器低下成为好的机器人，没有机器之下得到自由，随便生活的人。	搞不好这就是让孩子成为两种人格的人格体，机器底下成为好的机器人，没有机器之下得到自由，随便生活的人。
这样说实在也不太好，虽然可以快速的获得资讯，不过还是对身体和心理有不好的影响。	这样说实在也不太好，虽然可以快速地获得资讯，不过还是对身体和心理有不好的影响。
你一定会作好的。加油！	你一定会做好的。加油！
它以前只有巴黎、纽约等地方才有的导游书，因为它的记者经过好多次训练去餐厅。	它以前只有巴黎、纽约等地方才有的导游书，因为它的记者经过好多次训练去餐厅。
所以我们希望您有方法减少噪音和臭味，噪音部分短级我建议用噪音隔墙减少操音，长级建议工厂改善您们设备减少噪音。	所以我们希望您有方法减少噪音和臭味，噪音部分短期我建议用噪音隔墙减少噪音，长期建议工厂改善您们设备减少噪音。
他等了二十分钟，公车才来，而且今天的路上的车子必较多，公车碰到塞车了。	他等了二十分钟，公车才来，而且今天的路上的车子比较多，公车碰到塞车了。
如果孩子都知道爸爸妈妈可以看到他们上课的行为，他们就怕写念错误的答案，然后他们就比较慢的学道知识。	如果孩子都知道爸爸妈妈可以看到他们上课的行为，他们就怕写念错误的答案，然后他们就比较慢的学到知识。
看了很好看的电影他回家了，可是他被妈妈他了。	看了很好看的电影他回家了，可是他被妈妈骂了。
坐在沙发，喝酒和看般球给我很高兴。	坐在沙发，喝酒和看棒球给我很高兴。
以上所说的都是我们一起讨论的结果，也是我们的心愿希望你能早日解决这些问题让我闻可以快快乐乐地一起住在这片土地上。	以上所说的都是我们一起讨论的结果，也是我们的心愿希望你能早日解决这些问题让我们可以快快乐乐地一起住在这片土地上。
我想跟你一起去垦丁，因为我的朋友说哪里的天气很好，海边风景很美。	我想跟你一起去垦丁，因为我的朋友说那里的天气很好，海边风景很美。
他从是坐公车去学校。	他总是坐公车去学校。
那时候，应为校长觉得他获改，所以学生会受到很严重的制裁。	那时候，因为校长觉得他活该，所以学生会受到很严重的制裁。
近来天气很冷，听说现在有很多人根冒。	近来天气很冷，听说现在有很多人感冒。
因为越来越不满意。而且当老的时候会后悔他的意前生活的。	因为越来越不满意。而且当老的时候会后悔她的以前生活的。
当然阿当所有家长都可以看到在学校的活动的话，老师们也已经会更小心照顾小孩，也不会说老师们会用不好的方法来教学那些小孩。	当然啊当所有家长都可以看到在学校的活动的话，老师们也已经会更小心照顾小孩，也不会说老师们会用不好的方法来教学那些小孩。
我高中的时候都去读书馆看书。	我高中的时候都去图书馆看书。
您的工厂所排出的噪音与臭味，令我们无法享受舒服的生活，老幼青年都有奇怪的毛病所造成的、在深夜也辗转难娩，这些问题真威胁我们的生活太大了。	您的工厂所排出的噪音与臭味，令我们无法享受舒服的生活，老幼青年都有奇怪的毛病所造成的、在深夜也辗转难眠，这些问题真威胁我们的生活太大了。
以上是我门有一下建议希望您门留议处理。	以上是我们有一些建议希望您们留意处理。
我们全家那时也有像你现在的感觉。只得乖我们忘了记下来。	我们全家那时也有像你现在的感觉。只得怪我们忘了记下来。
你有那么多选择趁著好你的时间就没有理由报怨，就去开始做啦！	你有那么多选择趁著好你的时间就没有理由抱怨，就去开始做啦！
我认为现代社会里，奴人结婚生孩子以后，应该在家当个家庭专心照顾先生，孩子六－七年，然后在找工作。	我认为现代社会里，女人结婚生孩子以后，应该在家当个家庭专心照顾先生，孩子六－七年，然后再找工作。
我个人觉得我们人要有真觉得观念才是重要的，先知道对方需要什么然后适当的给予。	我个人觉得我们人要有真觉的观念才是重要的，先知道对方需要什么然后适当的给予。
女人比适合多点在家里照顾孩子，孩子小的时候妈妈都在家里可能会错过升值的机会。	女人比适合多点在家里照顾孩子，孩子小的时候妈妈都在家里可能会错过升职的机会。
念大学的时候，我也在网路玩过游戏，真得很好玩可是越玩越迷了。	念大学的时候，我也在网路玩过游戏，真的很好玩可是越玩越迷了。
他叫醒的时候，已经８点２０分左右。	他觉醒的时候，已经８点２０分左右。
他座呢个公车到学校，可是上课时间也已经十分过了。	他坐那个公车到学校，可是上课时间也已经十分过了。
摄影机的特色是可以看到小孩在教室里做什么，家长可以知道自己孩子上课的态度这么样，像又没有主动参加教室里的活动，每天学习什么等等。	摄影机的特色是可以看到小孩在教室里做什么，家长可以知道自己孩子上课的态度怎么样，像有没有主动参加教室里的活动，每天学习什么等等。
所以你也不要太在意，利用这个好机会放松一下，跟朋友在一起怀忆过去的好日。	所以你也不要太在意，利用这个好机会放松一下，跟朋友在一起回忆过去的好日。
我觉得我们在日本完五月，因为我没有工作。	我觉得我们在日本玩五月，因为我没有工作。
迷上网路的有些青少年是因为网路上有很多不同范畴的资讯，可以看他们所提供的资讯，也可以写自己的资讯，可以扩大自己的知识，而且很快得获得自己想要的资讯。	迷上网路的有些青少年是因为网路上有很多不同范畴的资讯，可以看他们所提供的资讯，也可以写自己的资讯，可以扩大自己的知识，而且很快地获得自己想要的资讯。
六根礼拜日晚上他在台北上中文课。	六跟礼拜日晚上他在台北上中文课。
但是，如果您不解决的话，我们为了保护人民的生化品质，和周边的环境，我们一定做到底。	但是，如果您不解决的话，我们为了保护人民的生活品质，和周边的环境，我们一定做到底。
在这忙绿的社会里，一个家庭家庭应该达到工作与生活的平衡。	在这忙碌的社会里，一个家庭家庭应该达到工作与生活的平衡。
他经常为了健康而走路去学校，到学校走路要三十分钟。	他经常为了健康而走路去学校，到学校走路要三十分钟。
如果两父母每天都得过著忙绿的工作生活，那么孩子们会在他们成长的过程，失去了很多亲子关系的互动。	如果两父母每天都得过著忙碌的工作生活，那么孩子们会在他们成长的过程，失去了很多亲子关系的互动。
虽然天气下雨，但是我来了，我即就踏著去。	虽然天气下雨，但是我来了，我骑脚踏车去。
所以我们希望您将知道我们的感觉、然后如何会节这个件事。	所以我们希望您将知道我们的感觉、然后如何会解这个件事。
那个地方有很多人，他们觉得非常热闹，所以李大明跟他们喜欢哪个地方。	那个地方有很多人，他们觉得非常热闹，所以李大明跟他们喜欢那个地方。
因为我妈妈从蒙古来了，这机天带她去医园。还要做的事情很多，累得不的了。	因为我妈妈从蒙古来了，这几天带她去医院。还要做的事情很多，累得不得了。
我刚刚来台北的时后，那里都不知道。	我刚刚来台北的时候，哪里都不知道。
我以前到文藻外语学院学中文的时候偶然发见附近有高雄市政府设立的对街友公益设施。	我以前到文藻外语学院学中文的时候偶然发现附近有高雄市政府设立的对街友公益设施。
想养宠物的人比再养宠物多了三倍，指不过他们的公寓太小，生活又忙碌紧张而放弃这个意愿。	想养宠物的人比在养宠物多了三倍，只不过他们的公寓太小，生活又忙碌紧张而放弃这个意愿。
他知道今天，高中三年级的最后一天，是个很重要的天。	他知道今天，高中三年级的最后一天，是个很重要的天。
希望你的冰块好，你的身体越来越健康！	希望你的病快好，你的身体越来越健康！
但不要因为有了电脑就埋头在电脑世界里，忘记了自己本分要做的事，需要随时提醒自己限制座在电脑前。	但不要因为有了电脑就埋头在电脑世界里，忘记了自己本分要做的事，需要随时提醒自己限制坐在电脑前。
那笔钱可以来用在教义方面。增加老师薪水、或著投资在语言、运动、数学具方面。	那笔钱可以来用在教育方面。增加老师薪水、或者投资在语言、运动、数学几方面。
苏嘉在台湾也没关系，如果我做实验做得很物料，我可以去看看很漂亮的地方，骇去夜市买东西。	暑假在台湾也没关系，如果我做实验做得很无聊，我可以去看看很漂亮的地方，还去夜市买东西。
最近天气常常有下噢，有很多人生病。	最近天气常常有下雨，有很多人生病。
我们都是好朋友，搜已我们请他出ＢＢＱ。	我们都是好朋友，所以我们请他吃ＢＢＱ。
为了减小噪音，请盖防音设备。	为了减少噪音，请盖防音设备。
即使我极力的反对网路交友，觉得危险，容易被骗色骗财，不现实等等。	即使我极力地反对网路交友，觉得危险，容易被骗色骗财，不现实等等。
他不但很聪明，害人人称羡的男生。他会当一个很好的老板。	他不但很聪明，还人人称羡的男生。他会当一个很好的老板。
那父母要怎么样邦助孩子发现他们的兴趣呢？最好用游戏来引导他们。	那父母要怎么样帮助孩子发现他们的兴趣呢？最好用游戏来引导他们。
看金融危机的深度，可以预见的几年好像现在的情况无法转好。我们必要早已点适应扭曲的现况。	看金融危机的深度，可以预见的几年好像现在的情况无法转好。我们必要早一点适应扭曲的现况。
走路的时候他试试看厅路上的汽车，就一位先生厅还告诉对我弟弟，他也到英国去，所以我弟弟可以跟他一起走。	走路的时候他试试看听路上的汽车，就一位先生厅还告诉对我弟弟，他也到英国去，所以我弟弟可以跟他一起走。
每天除非买东西意外都在家里，跟社会关的机会很少。	每天除非买东西以外都在家里，跟社会关的机会很少。
那样环保问题越类越突出的情况下，我们因该怎样保护环境呢？我们到底怎么处理花莲问题呢？	那样环保问题越来越突出的情况下，我们因该怎样保护环境呢？我们到底怎么处理花莲问题呢？
近来的社会之演变太快导致我们与小孩的想法之间产生巨大的落差，因此能了解小孩目前的想法，将让我们更有效率地跟其沟通以教育、辅导以及扶植。	近来的社会之演变太快导致我们与小孩的想法之间产生巨大的落差，因此能了解小孩目前的想法，将让我们更有效率地跟其沟通与教育、辅导以及扶植。
我认为踏入社会之前有一些打工的经验是相当直得的，尤其是与将来你想做的职业有关的打工。	我认为踏入社会之前有一些打工的经验是相当值得的，尤其是与将来你想做的职业有关的打工。
身为一个家长，我个人觉得家长和老师因该要限制青少年的上网时数。	身为一个家长，我个人觉得家长和老师应该要限制青少年的上网时数。
我听到妳们下个月要结婚了，我觉得很高兴，恭喜，恭喜。	我听到你们下个月要结婚了，我觉得很高兴，恭喜，恭喜。
我爸爸说他年经的时候大家都失业，没有工作。	我爸爸说他年轻的时候大家都失业，没有工作。
隔壁阿吗，可是越来越严重了。所以我代表住民这样写信给你。	隔壁阿嬷，可是越来越严重了。所以我代表住民这样写信给你。
可是要自造出一之手机就要花多少资源，更不用说是是浪费资源了。	可是要自造出一只手机就要花多少资源，更不用说是是浪费资源了。
星期六我有空所以我觉得八点半我跟你可以见面，所以我们会见面在忠孝敦化火者站３出口。	星期六我有空所以我觉得八点半我跟你可以见面，所以我们会见面在忠孝敦化火车站３出口。
为此我们都须要加强警戒、用脑行事，每个动作要三思而后行就能保证自己的安全和权益。	为此我们都须要加强警戒、用脑行事，每个动作要三思而后行就能保证自己的安全和权益。
我跟我的同学们，在上课感到无聊时，就会上网上线，不但不专心听课程，也同时再网路上玩，对我们一点都没有帮助。	我跟我的同学们，在上课感到无聊时，就会上网上线，不但不专心听课程，也同时在网路上玩，对我们一点都没有帮助。
我觉得这是好作法。因为如果可以上学校的网路站，就能看到小孩在教室里的情况。	我觉得这是好做法。因为如果可以上学校的网路站，就能看到小孩在教室里的情况。
如果你要的话，情你八点到我家。	如果你要的话，请你八点到我家。
最近您常常表示工作的负担太重，年纪也不清，希望会退休。	最近您常常表示工作的负担太重，年纪也不轻，希望会退休。
他们的衣服都不干。	他们的衣服都不干。
我对教室里该不该装录影机这个议题表我的看话是．．．我同意校长想的办法。	我对教室里该不该装录影机这个议题表我的看法是．．．我同意校长想的办法。
那就先这样吧，祝妳这件事情能够圆满若幕，在学校之后的生活当中也一切顺利。	那就先这样吧，祝妳这件事情能够圆满落幕，在学校之后的生活当中也一切顺利。
跟您将电话时，当时我好担心您，以后我想一想我们要怎么办。	跟您讲电话时，当时我好担心您，以后我想一想我们要怎么办。
可是他们，尤其是从来没有养过的人再开始养之前，只会想像养了以后有什么好的事情，却不考虑训练、照顾还有散步等等的辛苦。	可是他们，尤其是从来没有养过的人在开始养之前，只会想像养了以后有什么好的事情，却不考虑训练、照顾还有散步等等的辛苦。
我但然去了看医生，他说没什么关系，我只需要休息一下。	我当然去了看医生，他说没什么关系，我只需要休息一下。
因为中国反是很好，所以吃得很多我常常错共车去台大吃了饭。	因为中国饭是很好，所以吃得很多我常常坐公车去台大吃了饭。
今天我跟美美一起去看一前她要看的电影。	今天我跟美美一起去看以前她要看的电影。
那份统计结果只表示，名校毕业生趋向高新，并不表示不进入名校就没有未来的保障。	那份统计结果只表示，名校毕业生趋向高薪，并不表示不进入名校就没有未来的保障。
但是网路对青少年的意思育影响有些不同之处。	但是网路对青少年的意思与影响有些不同之处。
也不算是吃亏喔！对人生病不该失去信心喔！	也不算是吃亏喔！对人生并不该失去信心喔！
大家没有希望不那么都赚钱的话可以马？可是，现实不那么简单。	大家没有希望不那么都赚钱的话可以吗？可是，现实不那么简单。
这样，当地的年轻人就不会在到各地球生活。	这样，当地的年轻人就不会再到各地球生活。
第一位情第二位，他说：第二位你好。	第一位请第二位，他说：第二位你好。
他的朋友八点钟已经到了，比塞还没开始。	他的朋友八点钟已经到了，比赛还没开始。
林小安说：「好没问题，我可以帮你。请进我们一起回成市，好不好？」	林小安说：「好没问题，我可以帮你。请进我们一起回城市，好不好？」
去年，学生回家之后高二年级老师曾小姐留下来该考卷。	去年，学生回家之后高二年级老师曾小姐留下来改考卷。
电脑是让人方便性发明的，但是大家都很想要知道别人在做什么？也要投出来别人电脑里的东西。	电脑是让人方便性发明的，但是大家都很想要知道别人在做什么？也要偷出来别人电脑里的东西。
希望李长能静快（一个月内）把事情解决好。如果李长这边没有反应的话，我们会进一步以政府反应。	希望李长能尽快（一个月内）把事情解决好。如果李长这边没有反应的话，我们会进一步与政府反映。
自己在家里体验过这个情况，我会尽力的避免。	自己在家里体验过这个情况，我会尽力地避免。
当时，有数多人也来抗议，皆被挡在外面，我打听才知道，他们也是因为吃了在大明超市场购买蔬菜来做出的饭菜。	当时，有许多人也来抗议，皆被挡在外面，我打听才知道，他们也是因为吃了在大明超市场购买蔬菜来做出的饭菜。
今天是学校的最后一天，小朋友好兴奋得上学校的车。	今天是学校的最后一天，小朋友好兴奋地上学校的车。
现在我住在台湾，所以我不明白现在这么样，可是我觉得因该全世界一样青少年上网时间越来越增加。	现在我住在台湾，所以我不明白现在这么样，可是我觉得应该全世界一样青少年上网时间越来越增加。
可是，当事情发生了、我们因改以正面的态度去面对。	可是，当事情发生了、我们应该以正面的态度去面对。
我最近想了很久，总于想出来把问题解决的方法。	我最近想了很久，终于想出来把问题解决的方法。
我的未来的工作不会因影乐我的教训对我的父母亲与我的家人。	我的未来的工作不会阴影了我的教训对我的父母亲与我的家人。
虽说有线网路在当地的速度没有像台湾那么的快速，丝毫也没有影响他们使用网路的意愿。	虽说有线网路在当地的速度没有像台湾那么地快速，丝毫也没有影响他们使用网路的意愿。
几年前我在求业时周遇到的情况明确的表示进入名校不见得能获得高薪。	几年前我在求业时遭遇到的情况明确的表示进入名校不见得能获得高薪。
养孩子是一个伟大的责任，因此，父母全心全意作得好是不可以忽略的重要要素。	养孩子是一个伟大的责任，因此，父母全心全意做得好是不可以忽略的重要要素。
他问一个人「请问，到台科大师什么公车？」。	他问一个人「请问，到台科大是什么公车？」。
以前我朋友游泳的时候，她的东西像游泳衣啊、毛巾啊身么的放进去公用柜子。	以前我朋友游泳的时候，她的东西像游泳衣啊、毛巾啊什么的放进去公用柜子。
我干快洗澡，洗了一个澡，把我的包包上身，我跑路去等公车。	我赶快洗澡，洗了一个澡，把我的包包上身，我跑路去等公车。
网路交友是一件很浪费时间并危险的行为。	网路交友是一件很浪费时间并危险的行为。
她门从学校只要座五六分钟的公车到我家，因为她们觉得走路很累。	她们从学校只要坐五六分钟的公车到我家，因为她们觉得走路很累。
没想到已经两点钟了，他就干快去睡觉。	没想到已经两点钟了，他就赶快去睡觉。
其时这个举动是不必要的。你一旦决定把小孩送去学校是已经选择相信你的小孩已经独立，能在团体生活中过的非常好。	其实这个举动是不必要的。你一旦决定把小孩送去学校是已经选择相信你的小孩已经独立，能在团体生活中过的非常好。
原来是本校一个行动不便的残障学生，一手撑著被狂风吹得东歪西到的雨伞，另一手艰难地在湿滑的水泥地上滚动轮椅的轮子。	原来是本校一个行动不便的残障学生，一手撑著被狂风吹得东歪西倒的雨伞，另一手艰难地在湿滑的水泥地上滚动轮椅的轮子。
可是他觉得没关系因为现在他有奴朋友。	可是他觉得没关系因为现在他有女朋友。
我希望他学会打中文字，也学会打日文字，才可以跟日本和台湾两边的亲朋好友随时联络。	我希望她学会打中文字，也学会打日文字，才可以跟日本和台湾两边的亲朋好友随时联络。
他现在无所事事的都待在家里面，他有试著出去外面找工作，结果找不到。	他现在无所事事地都待在家里面，他有试著出去外面找工作，结果找不到。
现在经济发展时，一个家庭父妻养一个孩子。	现在经济发展时，一个家庭夫妻养一个孩子。
这位小姐说：你应该一直走到十只路口，再右砖一直走经过一家银行就到了。	这位小姐说：你应该一直走到十字路口，再右转一直走经过一家银行就到了。
王天华开心得一直说话。	王天华开心地一直说话。
现在重新开始码？可是我觉得很难，现在连年轻的人招工作很难，那么我呢。	现在重新开始吗？可是我觉得很难，现在连年轻的人找工作很难，那么我呢。
我自己会用电脑已请会了二十多年了，可是我第一次上网路是大概我开始上大学的时候，因为我们国家２０００年以后才变成了一个非要上网路不可的国家了。	我自己会用电脑已经会了二十多年了，可是我第一次上网路是大概我开始上大学的时候，因为我们国家２０００年以后才变成了一个非要上网路不可的国家了。
我以前看过台湾的自然的书，内容是蝴蝶王国。真是台湾一定保互自然环景。	我以前看过台湾的自然的书，内容是蝴蝶王国。真是台湾一定保护自然环景。
我门必要面对人与环境做一些平衡，所以研发新的绿色环保是将来的需求。	我们必要面对人与环境做一些平衡，所以研发新的绿色环保是将来的需求。
经济发展与环境保护，皆系政府最重要的任务之一，不能以一完全賸余二。	经济发展与环境保护，皆是政府最重要的任务之一，不能以一完全胜于二。
你是客人，请你座著休息，先看电视吧！	你是客人，请你坐著休息，先看电视吧！
问题不在出来外面、问题一定在各人里面。	问题不在出来外面、问题一定在个人里面。
大明来台北两天一后所以他不会走到他的学校。	大明来台北两天以后所以他不会走到他的学校。
对地球上的人来说你有两天的工作也不是只辛运的事，是死活的事，你是可活的。	对地球上的人来说你有两天的工作也不是只幸运的事，是死活的事，你是可活的。
我门明明知道自然的重要性，如果真轻视自然的话，自己陷入万丈的井。	我们明明知道自然的重要性，如果真轻视自然的话，自己陷入万丈的井。
有人反对大学生打工，是因为大学生因该专心念书而不因该在打工上浪费时间。	有人反对大学生打工，是因为大学生应该专心念书而不应该在打工上浪费时间。
可是他还是说我不能去看你，应为你应该多休息。	可是他还是说我不能去看你，因为你应该多休息。
外国学生说「对啊，我是市大学生可是我还没开始上中文课，谢谢你！」	外国学生说「对啊，我是师大学生可是我还没开始上中文课，谢谢你！」
但是他很利害每次准所上课的时间，而且撑起也不错，所以他对自己有信心。	但是他很厉害每次准时上课的时间，而且成绩也不错，所以他对自己有信心。
我去哪里，然后我要告诉你们恭喜你们！	我去那里，然后我要告诉你们恭喜你们！
二十世纪带来很多创新进社会应用。	二十世纪带来很多创新及社会应用。
虽然这是一个极为的例子，重点是小孩应该自由选择他们会不会被录影。	虽然这是一个极微的例子，重点是小孩应该自由选择他们会不会被录影。
不过经济不景气的这个时代，对人民、对学设有特殊的挑战，也有特殊的机会。	不过经济不景气的这个时代，对人民、对学生有特殊的挑战，也有特殊的机会。
就台湾而言，情况不堪相像比如：油价上涨，美国经济恶化影响压等。	就台湾而言，情况不堪想像比如：油价上涨，美国经济恶化影响压等。
怎么办？其实阿伟一整天水乐部曲学校了！	怎么办？其实阿伟一整天睡了不去学校了！
我们的家中午１３：００开时。	我们的家中午１３：００开始。
我们对工厂的音和臭味都受不了了。音和臭味从工厂对我们有很多不好得影响。	我们对工厂的音和臭味都受不了了。音和臭味从工厂对我们有很多不好的影响。
老师的薪要加比较高，因为他们是对孩子最近的人们，他们因该辛苦了。	老师的薪要加比较高，因为他们是对孩子最近的人们，他们应该辛苦了。
我听到我们公司要实无薪价后我没天准备自己的中餐带去上班，这样很好算也有觉得比较干净。	我听到我们公司要实无薪假后我每天准备自己的中餐带去上班，这样很划算也有觉得比较干净。
他问为什么我在这离自己站著然送我回火车站。	他问为什么我在这里自己站著然送我回火车站。
他差不多半年很努力学习，不过最近为了打声音压力很大。他的父母也很担心他。	他差不多半年很努力学习，不过最近为了大声音压力很大。他的父母也很担心他。
我不局道你要吃什么菜，可是我觉得中国菜很好。	我不知道你要吃什么菜，可是我觉得中国菜很好。
但问题是假如他上班至下班以来，小狗只好在家一只。	但问题是假如他上班至下班以来，小狗只好在家一直。
他跟林小安说谢谢、还有在见。	他跟林小安说谢谢、还有再见。
下一天他陪我去看风京，帮我排照。	下一天他陪我去看风景，帮我拍照。
那时候台北有蔡伊领的演唱会，大年说一定要去因为伊领又漂亮又会唱。	那时候台北有蔡依林的演唱会，大年说一定要去因为依林又漂亮又会唱。
我门是王天华的家人。	我们是王天华的家人。
我相信校方一定可以请技术人员做好最高阶的安全防护来维护我们小孩以及老师们的隐私，只让该班同学的家长们看到某班的影响。	我相信校方一定可以请技术人员做好最高阶的安全防护来维护我们小孩以及老师们的隐私，只让该班同学的家长们看到某班的影像。
因为小孩有时候很怪但是也有时候很调皮，可能发生很多情况不好，有时候老师不注意家人可能打电话来提请老师停止哪个情况。	因为小孩有时候很怪但是也有时候很调皮，可能发生很多情况不好，有时候老师不注意家人可能打电话来提醒老师停止哪个情况。
好像先托鸡的毛、然后在有油的锅里放进去，开始煮。	好像先脱鸡的毛、然后在有油的锅里放进去，开始煮。
你不需要因此而气馁，应该为著还可以有工作和收入而感恩，毕竟现在被裁员的人不断的增加。	你不需要因此而气馁，应该为著还可以有工作和收入而感恩，毕竟现在被裁员的人不断地增加。
老师告诉林达铭说一次，然后老是把这个字写上黑板。	老师告诉林达明说一次，然后老师把这个字写上黑板。
我是去年十一月二十三号来了，一经三个月多久了。	我是去年十一月二十三号来了，已经三个月多久了。
他已经跟老师说了他从昨天会开始用功，其实老师不在教室里的话他一直跟同学劳天，坐不住，也不认真。	他已经跟老师说了他从昨天会开始用功，其实老师不在教室里的话他一直跟同学聊天，坐不住，也不认真。
但是，有孩子的职业妇女太辛苦。社会应该办助她们。	但是，有孩子的职业妇女太辛苦。社会应该帮助她们。
有人说「父母都工作，孩子谁来照顾呢？」，其时，这是现代家庭的很大问题。	有人说「父母都工作，孩子谁来照顾呢？」，其实，这是现代家庭的很大问题。
此至，祝大安	此致，祝大安
他们都很累，还有有一点鹅。	他们都很累，还有有一点饿。
今天他很哩，不过有几个很重要的考试，他非及格不可。	今天他很累，不过有几个很重要的考试，他非及格不可。
一家中先生跟太太他们都有工作的话，可以受到两个收入，应该生活的品质好一点。	一家中先生跟太太他们都有工作的话，可以收到两个收入，应该生活的品质好一点。
哪里的天气很好，不太热也不太冷。	那里的天气很好，不太热也不太冷。
而且，可以利用媒体曝光这件事情，这因损害你们企业的印象，所以可能对你们企业未来的营运来说留下了很大的痕迹。	而且，可以利用媒体曝光这件事情，这应损害你们企业的印象，所以可能对你们企业未来的营运来说留下了很大的痕迹。
如果他真的不再需要这些ＣＤ，他起码应该感谢你，而且要换给你钱。	如果他真的不再需要这些ＣＤ，他起码应该感谢你，而且要还给你钱。
可是这样的孩子部见得都能成功。因为每个人的专长与兴趣不同。	可是这样的孩子不见得都能成功。因为每个人的专长与兴趣不同。
那个人可以自由的谈他们的兴趣，恐怕，梦想，也擦掉其他的人的反应。	那个人可以自由地谈他们的兴趣，恐怕，梦想，也擦掉其他的人的反应。
有控的时候跟朋友常常去夜市买好吃的东西或是买好看的衣服。	有空的时候跟朋友常常去夜市买好吃的东西或是买好看的衣服。
不过当初他又不是真的想让你买东西，而且东西又很多，有很贵，他不好意思接受。	不过当初他又不是真的想让你买东西，而且东西又很多，又很贵，他不好意思接受。
薪水少很多和工作天也变少，用另外角度来想，当作给自已的休息时间。	薪水少很多和工作天也变少，用另外角度来想，当作给自己的休息时间。
再加上我还算年轻的，对生意，管理这样的事情没有应验，我简直不适合当老板，我觉得你给我的责任真的太多，你对我的自信台，我真的很怕将会让家人失望。	再加上我还算年轻的，对生意，管理这样的事情没有经验，我简直不适合当老板，我觉得你给我的责任真的太多，你对我的自信太，我真的很怕将会让家人失望。
相信不仅是我的国家马来西亚，全世界的青少年也同样的面对沉迷于网路世界的问题。	相信不仅是我的国家马来西亚，全世界的青少年也同样面对沉迷于网路世界的问题。
所以不要把事情向的那么的不顺或心理充满压力，只要有学到东西的都把它当作很好的经历就好了。	所以不要把事情想得那么的不顺或心里充满压力，只要有学到东西的都把它当作很好的经历就好了。
譬如最近美国例子，我有很多朋友读名校，大学不读自己喜欢的系，念了经济或财务。	譬如最近美国例子，我有很多朋友读名校，大学不读自己喜欢的系，念了经济或财务。
这是我的看话。	这是我的看法。
在现代这个极速发展的社会，越来越多人认为小孩子应该提早接受正规教育。	在现代这个极速发展的社会，越来越多人认为小孩子应该提早接受正规教育。
大明进张得不得了。	大明紧张得不得了。
虽然他有地图可是没什么帮助还找不到学校。要问别人他们不会说英文很湖涂啦！	虽然他有地图可是没什么帮助还找不到学校。要问别人他们不会说英文很糊涂啦！
因为父母是孩子的榜样，所以孩子们会从父母的一举一动或者说话的技巧开始学起新的东西。	因为父母是孩子的榜样，所以孩子们会从父母的一举一动或者说话的技巧开始学习新的东西。
王天华，你好马？	王天华，你好吗？
秋天最漂亮，一点儿冷可是术都红色跟黄色。	秋天最漂亮，一点儿冷可是树都红色跟黄色。
所以爱文跟美美找一找控的时间，今天才来很大的电影院。	所以爱文跟美美找一找空的时间，今天才来很大的电影院。
上课的时候，老师文学生很难懂地问题。	上课的时候，老师问学生很难懂的问题。
此外还有臭味的问题，我们还不知道怎么方法可以解决这种问题，但是今天在网路我找到一个网页提供公司的服务是减少工厂的废气。	此外还有臭味的问题，我们还不知道什么方法可以解决这种问题，但是今天在网路我找到一个网页提供公司的服务是减少工厂的废气。
里你们工厂五公里也闻得到，不用说我们只在工厂附近，我们哪受得了呢？	离你们工厂五公里也闻得到，不用说我们只在工厂附近，我们哪受得了呢？
他也很喜欢发山。	他也很喜欢爬山。
我明天不难上课，因为明天我妈妈要来台湾。	我明天不能上课，因为明天我妈妈要来台湾。
我么住在新店图书馆的旁边。	我们住在新店图书馆的旁边。
我觉得这件事情跟你的中文程度也没什么关系，而且你的中文好的不得了，不是他自己说的吗？	我觉得这件事情跟你的中文程度也没什么关系，而且你的中文好得不得了，不是他自己说的吗？
下了课大华就会去念书，在家里准备复习从第一课到第三课。	下了课大华就回去念书，在家里准备复习从第一课到第三课。
方便规方便，但网路也会有很多黑网站、很多诱惑让很多青少年因为不懂事、好奇等很容易被带坏。	方便归方便，但网路也会有很多黑网站、很多诱惑让很多青少年因为不懂事、好奇等很容易被带坏。
为了让他们爱生活俄并让他们成为一个热心的人，这群人不想给孩子太多压力。	为了让他们爱生活而并让他们成为一个热心的人，这群人不想给孩子太多压力。
我所说给您听这些只是一部分而已，如果您不相信可以来到我们的村子一目了然。	我所说给您听这些只是一部分而已，如果您不相信可以来到我们的村子一目了然。
他快进座下，下课以后跟老师说「不好意思！昨晚很晚才睡觉。」	他快进坐下，下课以后跟老师说「不好意思！昨晚很晚才睡觉。」
如果再２个月内，您的工厂没办法解决这个问题，我们只能请环保署来处。	如果在２个月内，您的工厂没办法解决这个问题，我们只能请环保署来处。
家常可以看到小孩在教室里的情况会帮助谁？小孩或者家长？	家长可以看到小孩在教室里的情况会帮助谁？小孩或者家长？
我很愿意参加可是庆祝会的时候我们的公司有一个重要的是。	我很愿意参加可是庆祝会的时候我们的公司有一个重要的事。
在说，我觉得这里也可以有很好玩，也可以学很多很好的东西。	再说，我觉得这里也可以有很好玩，也可以学很多很好的东西。
经济发展方面，可以将华连成为国家观逛景点，以旅游行业为主来发展当地的经济，教育当地人们懂得保护自己拥有之宝。	经济发展方面，可以将花莲成为国家观逛景点，以旅游行业为主来发展当地的经济，教育当地人们懂得保护自己拥有之宝。
其实白天有多多少少地噪音我们都可以理解，而且白天我们都在上班不在家里，没有什么问题。	其实白天有多多少少的噪音我们都可以理解，而且白天我们都在上班不在家里，没有什么问题。
到了时候，他们就开始考食物。	到了时候，他们就开始烤食物。
老是说没关喜不瑳胎多。	老师说没关系不说太多。
在这种情快下，反而物价变高，食物价格在涨，水电费何油价也一样，真的每天过著辛苦的一天。	在这种情况下，反而物价变高，食物价格在涨，水电费和油价也一样，真的每天过著辛苦的一天。
再这题目有提出用电脑来看小朋友在教室里的情况，这样的方法虽然有很多的人同意可是还有不少的人反对。	在这题目有提出用电脑来看小朋友在教室里的情况，这样的方法虽然有很多的人同意可是还有不少的人反对。
我觉得你因该利用这个机会更充实自己的生活。	我觉得你应该利用这个机会更充实自己的生活。
弟弟请来的朋友写一张卡片给他，他请朋友来下面完儿。	弟弟请来的朋友写一张卡片给他，他请朋友来下面玩儿。
每天一大早起来就会闻到臭味，不尽对身体不好还会养出很多种毛病像头痛了、胃痛了等等。	每天一大早起来就会闻到臭味，不仅对身体不好还会养出很多种毛病像头痛了、胃痛了等等。
有工作经验助于个人的休养寒食及工作能力。	有工作经验助于个人的修养和实际工作能力。
我很高兴听说你已经找到了工作。我真恭喜妳阿。	我很高兴听说你已经找到了工作。我真恭喜妳啊。
今天大明第一次到十大去，他是新生在师大。	今天大明第一次到师大去，他是新生在师大。
我们的技术越来越发展但是我们的环境比方说空气阿、水阿、土地阿、越来越坏掉了。]	我们的技术越来越发展但是我们的环境比方说空气啊、水啊、土地啊、越来越坏掉了。]
针对这个说法，我反应是：我们自己的孩子什么时候变成别人呢？难道我们不想要知道我们的小孩在学校时候平不平安吗？他上课的时候有没有怪怪的听老师、有没有积极的参与课堂讨论、有没有尊重其他同学等？	针对这个说法，我反应是：我们自己的孩子什么时候变成别人呢？难道我们不想要知道我们的小孩在学校时候平不平安吗？他上课的时候有没有乖乖的听老师、有没有积极的参与课堂讨论、有没有尊重其他同学等？
他看了很多簧片电影，然后生了沉感病。最后他自杀了！这一件故事真实反映了当代的一种现象。	他看了很多黄片电影，然后生了沉感病。最后他自杀了！这一件故事真实反映了当代的一种现象。
他跟同学在讨论，前面在黑板上有数学的共识。	他跟同学在讨论，前面在黑板上有数学的公式。
现在的妳一定感到非常的委曲，因为我也经历过类似的事，所以我想我可以感同身受。	现在的妳一定感到非常的委屈，因为我也经历过类似的事，所以我想我可以感同身受。
如何能够保持经济地迅速发展又保护自然环境是如今各国的难题。	如何能够保持经济的迅速发展又保护自然环境是如今各国的难题。
可是，大自然一段坏破了，就不容易恢复。	可是，大自然一旦坏破了，就不容易恢复。
因为网路的发达，大家变的越来越宅，喜欢待在家里，拒绝和人类接触。	因为网路的发达，大家变得越来越宅，喜欢待在家里，拒绝和人类接触。
我们觉得有一些作势李长厂可以提出来减少噪音和臭味的问题。	我们觉得有一些做事李长厂可以提出来减少噪音和臭味的问题。
摄影机低下可能表现得很好，但是这就是代表教室外面的生活表现吗？	摄影机底下可能表现得很好，但是这就是代表教室外面的生活表现吗？
我必须在实验室做实验，应为明年我要毕业了。	我必须在实验室做实验，因为明年我要毕业了。
如果我有空的时候，我们在一块儿去看电影好不好？	如果我有空的时候，我们再一块儿去看电影好不好？
那种喜欢上网得人都是拿别人的想法来用，不想用自己的想法。	那种喜欢上网的人都是拿别人的想法来用，不想用自己的想法。
我赶快起床不洗澡，去公车站，但是有很多人而且赛车。	我赶快起床不洗澡，去公车站，但是有很多人而且塞车。
邻居们也都认为工厂的噪音和臭味对我们的健康以及心里的影响很不好。	邻居们也都认为工厂的噪音和臭味对我们的健康以及心理的影响很不好。
大战后的社会，是属于农业社会，所以对教育比较不重视，因此大部分的时间都在帮忙农耕与家事，剩下的时间是在田里玩的。	大战后的社会，是属于农业社会，所以对教育比较不重视，因此大部分的时间都在帮忙农耕与家事，剩下的时间是在田里玩的。
天下的父母对自己孩子的爱心都莫过于任何情感，但我想倒不必在教室里装摄影机来检视。	天下的父母对自己孩子的爱心都莫过于任何情感，但我想倒不必在教室里装摄影机来监视。
我们住在贵厂的邻居都愿意把一笔钱给贵公司，但是如果这样做的话，摆脱厂长赶快处理问题，因为目前有人真是很失望。	我们住在贵厂的邻居都愿意把一笔钱给贵公司，但是如果这样做的话，拜托厂长赶快处理问题，因为目前有人真是很失望。
那你的女朋友最近还好吗？你没提到！她还会不会吵买方卖车？	那你的女朋友最近还好吗？你没提到！她还会不会吵买房买车？
进时代所有的人都知道不管来到甚么商店或做成任何交通工具当然会有摄影机观察您的行为，确保所来场所的人好好的行为因此公所的安全。	近时代所有的人都知道不管来到甚么商店或坐乘任何交通工具当然会有摄影机观察您的行为，确保所来场所的人好好的行为因此公所的安全。
这个行为应起了很多人的讨论。到底教室里该不该装摄影机？以我个人的想法，我很不赞成装摄影机这个事。	这个行为引起了很多人的讨论。到底教室里该不该装摄影机？以我个人的想法，我很不赞成装摄影机这个事。
这下子，他不得不冲动地检察你的东西。	这下子，他不得不冲动地检查你的东西。
不过你还是可以把有些钱拿回来吧。说不定你可以去书店退货或著把他的东西换成你自己需要的书。我猜老板会愿意吧。	不过你还是可以把有些钱拿回来吧。说不定你可以去书店退货或者把他的东西换成你自己需要的书。我猜老板会愿意吧。
「学校黑网站」不但被欺负的人的私人隐私泄漏到全校而且泄漏到全国，甚至些漏到全球。	「学校黑网站」不但被欺负的人的私人隐私泄漏到全校而且泄漏到全国，甚至泄漏到全球。
为了方便消费者的需求，电脑科技操作各种各样的日常生活的一切而又可以不需「劳私动众」的从手机与世界各地连线，促进了人与人之间的沟通与连结。	为了方便消费者的需求，电脑科技操作各种各样的日常生活的一切而又可以不需「劳师动众」的从手机与世界各地连线，促进了人与人之间的沟通与连结。
在客厅我说了，请座等一下，请看电视。	在客厅我说了，请坐等一下，请看电视。
妳怎么了？为什么这样很严重？	你怎么了？为什么这样很严重？
因为你们工厂有臭味影响到我们的附近，我代表跟你谈一下，我要你们敢换空汽还有声音，这样我们生活当中有环保，大家生活能安心快乐。	因为你们工厂有臭味影响到我们的附近，我代表跟你谈一下，我要你们敢换空气还有声音，这样我们生活当中有环保，大家生活能安心快乐。
所以如果他误认为了你也不是甚么奇怪的事。而且还正明说妳是他认为最近的一个人。	所以如果他误认为了你也不是甚么奇怪的事。而且还证明说妳是他认为最近的一个人。
而且结婚以后也女人非去上班不可。不然没办法生孩子，痒孩子。	而且结婚以后也女人非去上班不可。不然没办法生孩子，养孩子。
他心里真不安，应为这一次的考试很重要。	他心里真不安，因为这一次的考试很重要。
那台湾经挤也一蟹不如一蟹。如今，经济发展是台湾国民的焦点了。	那台湾经济也一蟹不如一蟹。如今，经济发展是台湾国民的焦点了。
让父母看到他们的美好时刻、用公读书、与老师和朋友们有如何关系等情形。	让父母看到他们的美好时刻、用功读书、与老师和朋友们有如何关系等情形。
可是一个月后她妈妈发现了她的手机费用太贵，问她到底用手机座什么。	可是一个月后她妈妈发现了她的手机费用太贵，问她到底用手机做什么。
今天我的妈妈要回国，但是早上睡觉所以迟到了飞机，现在美邦法。	今天我的妈妈要回国，但是早上睡觉所以迟到了飞机，现在没办法。
他们就觉得很无聊所以养动物，就过一段时间他们也不要养了，所以也不好好照顾有的人也留牠们在路上这样也会有成市的问题。	他们就觉得很无聊所以养动物，就过一段时间他们也不要养了，所以也不好好照顾有的人也留牠们在路上这样也会有城市的问题。
间题是，为了让小朋友们玩，老师们应该多加注意又他们自己应该多准备。	问题是，为了让小朋友们玩，老师们应该多加注意又他们自己应该多准备。
可是我看地图的时候在哪里有好吃的餐厅、在那里有很有名的公园都看不懂。	可是我看地图的时候在哪里有好吃的餐厅、在哪里有很有名的公园都看不懂。
因为住民的一部分在你工厂工作，我们也不希望失去工作的机会，你也因该不希望裁员很多员工，也不愿意做麻烦的叫纷。	因为住民的一部分在你工厂工作，我们也不希望失去工作的机会，你也应该不希望裁员很多员工，也不愿意做麻烦的纠纷。
昨天他写很多公克，所以今天他很累。	昨天他写很多功课，所以今天他很累。
所以你不要想你很参了，让自己开心一点。	所以你不要想你很惨了，让自己开心一点。
还好我们还由电子信。感谢你喔，电子邮件。	还好我们还有电子信。感谢你喔，电子邮件。
那宠物出租公司的最优点是出租以前有面试并训练课程，这很有信用得事。	那宠物出租公司的最优点是出租以前有面试并训练课程，这很有信用的事。
后来才发现那个聚会我是不能参加的，对方是东方人，因为不好意思礼貌上的邀约罢了！想不到我遽然会出席，可想而知场面是多么尴尬。	后来才发现那个聚会我是不能参加的，对方是东方人，因为不好意思礼貌上的邀约罢了！想不到我居然会出席，可想而知场面是多么尴尬。
我们刚刚就结束了我们的期中考试，所以我们要休息一点。	我们刚刚就结束了我们的期中考试，所以我们要休息一天。
李大明说他不要客气、请座。	李大明说他不要客气、请坐。
加油！这间是不是你的问题，不是你看起来小兔的样子发生这个问题，这就是容易怀疑别人的他的问题。	加油！这件事不是你的问题，不是你看起来小兔的样子发生这个问题，这就是容易怀疑别人的他的问题。
二来这次被骗也使他对电脑和网路感到非常的讨厌，直接影响他原本以电脑为主的工作。	二来这次被骗也使他对电脑和网路感到非常地讨厌，直接影响他原本以电脑为主的工作。
我们已经绿影您的工厂产多大的噪音，还有住民去了医院的时候医生检查生病跟您的工厂的关系。	我们已经录影您的工厂产多大的噪音，还有住民去了医院的时候医生检查生病跟您的工厂的关系。
跟同学快快乐乐地打工，不知不觉的赚钱，根本感觉不到工作辛苦。	跟同学快快乐乐地打工，不知不觉地赚钱，根本感觉不到工作辛苦。
我发现这个消息马上去超级市场买菜的地方告诉他们，却被抢在门外，所以我决定告诉您们这个情况。	我发现这个消息马上去超级市场买菜的地方告诉他们，却被挡在门外，所以我决定告诉您们这个情况。
而且社会也需要地人才是既有能力又有经验的，更何况立即学会的，董事的人是最必要的。	而且社会也需要的人才是既有能力又有经验的，更何况立即学会的，懂事的人是最必要的。
针对人生关点上的看法应概给我门小孩子一个自然生活，快乐成长。不管他门太紧，让他门有自我空间处理他门问题。	针对人生观点上的看法应该给我们小孩子一个自然生活，快乐成长。不管他们太紧，让他门有自我空间处理他门问题。
阿！我差不多忘记啰。很感谢你来参加我的生日派对。	啊！我差不多忘记啰。很感谢你来参加我的生日派对。
工厂的臭味影响附近的住民健康，呼吸的评析。	工厂的臭味影响附近的住民健康，呼吸的品质。
你们一定要做八八的公车到我们家来！从台北车站到我们家要做一个小时！	你们一定要坐八八的公车到我们家来！从台北车站到我们家要坐一个小时！
我觉得很多人喜欢买黑色的书包应为不容易攒，我觉得擦啡色也漂亮。	我觉得很多人喜欢买黑色的书包应为不容易脏，我觉得咖啡色也漂亮。
现阶段的这个非常时期我们也只好咬紧牙关，努力渡过难关。	现阶段的这个非常时期我们也只好咬紧牙关，努力度过难关。
如果自以为是名校毕业因该有高薪水，自己要想，我大学毕业生没经验，为何公司必须付我那么多钱。	如果自以为是名校毕业应该有高薪水，自己要想，我大学毕业生没经验，为何公司必须付我那么多钱。
俗语说的好：「读书破万卷，下笔如有神」的这句话很符合我现在的情况，因为我现在看很多不同哲学有关的书籍。	俗语说得好：「读书破万卷，下笔如有神」的这句话很符合我现在的情况，因为我现在看很多不同哲学有关的书籍。
阿，完蛋了！快八点了。	啊，完蛋了！快八点了。
他的班有一位王大明喜欢的人，可是她还不知道：这是王大明的米米！	他的班有一位王大明喜欢的人，可是她还不知道：这是王大明的秘密！
有一位老阿妈她说：你们到底知不知道现在几点了吗？这是中午的时间，最少让老人家休息一下，每天这样谁受得了！	有一位老阿嬷她说：你们到底知不知道现在几点了吗？这是中午的时间，最少让老人家休息一下，每天这样谁受得了！
他们准备了很多吃的东西，像烤烧，汽水、什么的。	他们准备了很多吃的东西，像烤烧，汽水、什么的。
有些父母反对您的作法，我认识很久的一个朋友也是。	有些父母反对您的做法，我认识很久的一个朋友也是。
我知道，你很久以前找工作很幸苦。	我知道，你很久以前找工作很辛苦。
这样对小孩子的安全好，还会让父母请放心。	这样对小孩子的安全好，还会让父母亲放心。
我们是好朋友所以我会一值在你身边，有事就可以与我连络。	我们是好朋友所以我会一直在你身边，有事就可以与我连络。
但是你还要自己养它们或是有时间部它们这样是最好。因人与宠物的关系很密切。最了解你的宠也是你自己。	但是你还要自己养它们或是有时间陪它们这样是最好。因人与宠物的关系很密切。最了解你的宠也是你自己。
所以家长们为了自己孩子的未来，应该适当的限制他们上网时数。	所以家长们为了自己孩子的未来，应该适当地限制他们上网时数。
要是你有空，我们找的时间聊吧！	要是你有空，我们找个时间聊吧！
他还需要撘公车去学校，以到车站的时候，他发现很多人在公车上排队。	他还需要搭公车去学校，一到车站的时候，他发现很多人在公车站排队。
他穿蓝色的牛仔裤根背一个黑色的背包。	他穿蓝色的牛仔裤跟背一个黑色的背包。
教师连庄摄影机的作法是一个好作法而不会害任何人。	教室里装摄影机的做法是一个好做法而不会害任何人。
所以不是只有恨激烈的学生，也会有激烈的父母。	所以不是只有很激烈的学生，也会有激烈的父母。
当然这不但局限在花莲的情况，而是我认为全世界都要这样的角度来看，来对待我门的环境。	当然这不但局限在花莲的情况，而是我认为全世界都要这样的角度来看，来对待我们的环境。
天华走路很快，怕公车来了，不然他还要等２０分钟等下一半的公车。	天华走路很快，怕公车来了，不然他还要等２０分钟等下一班的公车。
今天早藏，我们八点出公车赞。	今天早上，我们八点出公车站。
父母都让我们有自己的想法，解决问题，再加上受到教育，所以觉得女人也可以坐跟男人一样。	父母都让我们有自己的想法，解决问题，再加上受到教育，所以觉得女人也可以做跟男人一样。
所以我觉得除非接受安宁疗护的病人为了跟宠物一起过好好地过余生，也可以利用这种宠物出租公司。	所以我觉得除非接受安宁疗护的病人为了跟宠物一起过好好地过余生，也可以利用这种宠物出租公司。
反而，只好让他们每天上网已定的时间。要不然就有很严格的制裁。	反而，只好让他们每天上网一定的时间。要不然就有很严格的制裁。
然而，政府的计划常常缺少更重要的考量：城市里的建筑物是可以反复地冲盖，可是大自然一旦被破坏了是无发挽救的。	然而，政府的计划常常缺少更重要的考量：城市里的建筑物是可以反复地重盖，可是大自然一旦被破坏了是无法挽救的。
我替成这位校长的做法，装摄影机在教室理并不是不好的。	我赞成这位校长的做法，装摄影机在教室里并不是不好的。
反正校长也可以看教室里的情况这么样，所以校长知道老师是对的还是有问题。	反正校长也可以看教室里的情况怎么样，所以校长知道老师是对的还是有问题。
听说你准备开一个祝会，那天我不能跟你参加。我很抱见阿。	听说你准备开一个祝会，那天我不能跟你参加。我很抱歉啊。
我的工作里在印尼有很多人会说华文，所以我也要会说跟写中国子。	我的工作里在印尼有很多人会说华文，所以我也要会说跟写中国字。
在某某大校的行销系的教课非常轻松。	在某某大校的行销系的教课非常轻松。
他排照风景，然后外面一点儿黑了，他想下山去以后回家。	他拍照风景，然后外面一点儿黑了，他想下山去以后回家。
我们来家里面，然后讨润以下怎么回去。	我们来家里面，然后讨论一下怎么回去。
爸爸请你在一次想一想好好儿的办法。	爸爸请你再一次想一想好好儿的办法。
因为爱美是文德的最爱的朋友，所以他清她吃饭以后去看一部电影。	因为爱美是文德的最爱的朋友，所以他请她吃饭以后去看一部电影。
我们受不了了！李厂厂你必须改变工厂！我要告诉您怎么解决我们的问题。	我们受不了了！李厂长你必须改变工厂！我要告诉您怎么解决我们的问题。
作天我看到你太太，她告诉你有感冒。	昨天我看到你太太，她告诉你有感冒。
而且工厂造成的臭味也害他打开窗户，结果呢他选著了这个方案，宁可留在学校读书，不要回家。	而且工厂造成的臭味也害他打开窗户，结果呢他选择了这个方案，宁可留在学校读书，不要回家。
在这方面，我们再一次会看到庄录影机对很多人的好印象，装录影机也会让父母们放心。	在这方面，我们再一次会看到装录影机对很多人的好影响，装录影机也会让父母们放心。
我门可以到外面，吃很多东西了。	我们可以到外面，吃很多东西了。
你知道吗？其实我们的公司也上个月开始实施「无薪徦」了。	你知道吗？其实我们的公司也上个月开始实施「无薪假」了。
请您阅读下面的内容之后回复。我会表达您的立场与邻居沟通。为了这里的居民及贵工厂作为沟通的桥梁是我的荣兴。	请您阅读下面的内容之后回复。我会表达您的立场与邻居沟通。为了这里的居民及贵工厂作为沟通的桥梁是我的荣幸。
感谢等五分以后，碰到一位很棒的奴生跟我可聊。	感谢等五分以后，碰到一位很棒的女生跟我可聊。
我选来波澜的时间很好，因为一般来说夏天的天气很好、产的水果和青菜很多，好吃也便宜。	我选来波兰的时间很好，因为一般来说夏天的天气很好、产的水果和青菜很多，好吃也便宜。
我想因为租动物前要透过训练所以我这颗热心疼爱动物的决对部会伤害到小狗小猫的。	我想因为租动物前要透过训练所以我这颗热心疼爱动物的绝对不会伤害到小狗小猫的。
虽然你也自己说，幸亏你还有工作，所以请你每周两天好好地工作，为了提高自己的能力，另外每周五天，请你好好地学习自己有兴趣的事情。	虽然你也自己说，幸亏你还有工作，所以请你每周两天好好地工作，为了提高自己的能力，另外每周五天，请你好好地学习自己有兴趣的事情。
外面的人不知道背景也看到那些像片或动画就闹个不停。	外面的人不知道背景也看到那些相片或动画就闹个不停。
在我的国家，大学生打工的情况也普遍。不至大学生，很多高中生已经有一些打工的经验。	在我的国家，大学生打工的情况也普遍。不只大学生，很多高中生已经有一些打工的经验。
我们都知道，电脑及网罗的发展棒人类历史写下了新页。	我们都知道，电脑及网络的发展帮人类历史写下了新页。
生意不是很好的，但是根「无新加」的时候比己来好多了。	生意不是很好的，但是跟「无薪假」的时候比起来好多了。
因为不见得聪名校出来都能干，都会做事的人。	因为不见得从名校出来都能干，都会做事的人。
今天是他一次有棵可是他不局道怎么去。	今天是他一次有课可是他不知道怎么去。
可是先告诉你，我们的希望就是要回到跟以前一样即安静又舒适的生活，尤其是早上与晚上不要拿钱来决定。	可是先告诉你，我们的希望就是要回到跟以前一样既安静又舒适的生活，尤其是早上与晚上不要拿钱来决定。
你请我去你的无会以前，我原来要去跟你们静祝静竹，一定很好玩。	你请我去你的舞会以前，我原来要去跟你们庆祝庆祝，一定很好玩。
爸爸，我真得很喜欢中文，我觉得我有天分，也很想当大学老师，想把我辛辛苦苦地累积起来的知识传给学生，使得他们学到正确又更深入的东西。	爸爸，我真的很喜欢中文，我觉得我有天分，也很想当大学老师，想把我辛辛苦苦地累积起来的知识传给学生，使得他们学到正确又更深入的东西。
我喜欢做中国菜，吃中国菜，还有喜欢台湾得风景，每个地方都很美。	我喜欢做中国菜，吃中国菜，还有喜欢台湾的风景，每个地方都很美。
电脑在生活中不可缺少的物品，每个家庭都有续求用电脑，所以很多公司卖电子都推厂很多新产品，价钱很便宜。	电脑在生活中不可缺少的物品，每个家庭都有需求用电脑，所以很多公司卖电子都推厂很多新产品，价钱很便宜。
我赞同对严青少年上网时间。上网时间要在家里，去外面时间越来越少，部健看。	我赞同对严青少年上网时间。上网时间要在家里，去外面时间越来越少，不健康。
臭味部分希望您有设备处理，给我门好的生活谎竟。	臭味部分希望您有设备处理，给我们好的生活环境。
简单的说，你要运用的个时间来投资你自己，努力的做你喜欢做的事，以后一定会成功！	简单地说，你要运用这个时间来投资你自己，努力地做你喜欢做的事，以后一定会成功！
我恨情张到学校以后我快跑上课，到教室我看到老师和同学在上课。	我很紧张到学校以后我快跑上课，到教室我看到老师和同学在上课。
于是用已准备的奖炒。随奖的味道跟著全集的味道不一样。	于是用已准备的酱炒。随酱的味道跟著全鸡的味道不一样。
我们提案傱早上９点上班到晚上６点下班。这样我们比较方便。对您们工厂的人也因该方便。	我们提案从早上９点上班到晚上６点下班。这样我们比较方便。对您们工厂的人也应该方便。
这个情况发声过以后，我们的关系并没有以前的那么好。他真的赔了夫人又折兵﹗	这个情况发生过以后，我们的关系并没有以前的那么好。他真的赔了夫人又折兵﹗
情爱的李厂长！	亲爱的李厂长！
有一天他奇照片给我妈妈，连我们家里的地址他也写错。	有一天他寄照片给我妈妈，连我们家里的地址他也写错。
下课了以后学生多要做公车回家，在公车上小白坐不下了所以他得站著回家，对他来说很累可是没办法。	下课了以后学生都要坐公车回家，在公车上小白坐不下了所以他得站著回家，对他来说很累可是没办法。
下午的时候除了看很多漂亮的术，还有很多特别的花。	下午的时候除了看很多漂亮的树，还有很多特别的花。
你的日字都好吗？我很高兴你找到了工作啊！	你的日子都好吗？我很高兴你找到了工作啊！
话说回来，李厂长重新开场对我城市的经济有正面的影响。	话说回来，李厂长重新开厂对我城市的经济有正面的影响。
我相心男同学他本身有毛病，换句话说，我认为这一场误会并不是妳个人的问题，而是他心理上或个性上的问题。	我相信男同学他本身有毛病，换句话说，我认为这一场误会并不是妳个人的问题，而是他心理上或个性上的问题。
所以给别人照顾到不如妈妈自己照顾。	所以给别人照顾倒不如妈妈自己照顾。
对这些人要看绿色至少１５分钟、绿色会给人的研舒服的感觉、但是没有真正绿色的环境、那我们又要开始研究为了绿色的绿色、那也要花钱。	对这些人要看绿色至少１５分钟、绿色会给人的颜舒服的感觉、但是没有真正绿色的环境、那我们又要开始研究为了绿色的绿色、那也要花钱。
假如孩子一直没有跟同学玩儿，孤独一个人坐著，那透过了摄影机父母就知道了这件事情，来的及与老师和孩子沟通，找出问题。	假如孩子一直没有跟同学玩儿，孤独一个人坐著，那透过了摄影机父母就知道了这件事情，来得及与老师和孩子沟通，找出问题。
总算是你的公司就交给我，可是我要有时间已翻翻看我自己的工作，以方面练习当老板人的方法。	总算是你的公司就交给我，可是我要有时间以翻翻看我自己的工作，一方面练习当老板人的方法。
所以常跟学生随便用不合适的话而说，是学生非常难过和大的压力，引起不要继续念书的心理。	所以常跟学生随便用不合适的话而说，使学生非常难过和大的压力，引起不要继续念书的心理。
刚来台湾的时候，我什么都不知到，因为我没学过中文所以我不会看、说中文字。	刚来台湾的时候，我什么都不知道，因为我没学过中文所以我不会看、说中文字。
只不到三年过后，使用网路上网的人数快速的增加，尤其是青少年使用占６０％以上，而且平均时数也差不１天５个小时，现在应该不只了。	只不到三年过后，使用网路上网的人数快速地增加，尤其是青少年使用占６０％以上，而且平均时数也差不１天５个小时，现在应该不只了。
希望妳能开心的渡过这学期。下次见。	希望妳能开心的度过这学期。下次见。
总之，我本人认为在教室里不该装摄影机，因为这样的行为或造成许多的缺点，也在造成学习的困扰与学习的动机。	总之，我本人认为在教室里不该装摄影机，因为这样的行为会造成许多的缺点，也在造成学习的困扰与学习的动机。
白天机械可替换轮流运转以减少噪因。	白天机械可替换轮流运转以减少噪音。
一份耕耘一份收获，只要努力的从事自己的工作，不管收入的高低未来一定有充实的人生。	一分耕耘一分收获，只要努力的从事自己的工作，不管收入的高低未来一定有充实的人生。
我觉得如果没有甚么可以证明一个人作甚么，那不能怪别人。	我觉得如果没有甚么可以证明一个人做甚么，那不能怪别人。
我真的恨高兴你已经找到了一份工作了。	我真的很高兴你已经找到了一份工作了。
我们已经相信他们而委托指导学生，装摄影机就证明不相信他们，这就是不合理的、茅盾的行为。	我们已经相信他们而委托指导学生，装摄影机就证明不相信他们，这就是不合理的、矛盾的行为。
不过受一个挫折张一个知识，你的同步要的东西，不想换钱给你也没办法勉强他，所以这事儿就算了。	不过受一个挫折长一个知识，你的同不要的东西，不想换钱给你也没办法勉强他，所以这事儿就算了。
电影叫「ＷＡＬＬ－Ｅ」，我觉得是很客爱的电影。	电影叫「ＷＡＬＬ－Ｅ」，我觉得是很可爱的电影。
有些人因为觉得可爱宠物而买宠物，他们要买宠物的理由是很单顿的。	有些人因为觉得可爱宠物而买宠物，他们要买宠物的理由是很单纯的。
因此我确实可以理解你的期望，不够我控恐怕我没办法对应你的要求。至是我今天写这封信给你的原因之一。	因此我确实可以理解你的期望，不过我控恐怕我没办法对应你的要求。这是我今天写这封信给你的原因之一。
最近我们邻居因为了一件事而烦恼，我们觉得非跟您商量不可。我代表我们附近的邻区向您报告。	最近我们邻居因为了一件事而烦恼，我们觉得非跟您商量不可。我代表我们附近的邻居向您报告。
所以我们介意您们，您们很快处理，因为真的大家受不了了。谢谢您们！	所以我们建议您们，您们很快处理，因为真的大家受不了了。谢谢您们！
大家都知道贵工厂为我们社区一直不断的努力让社区成长，但是我们还是希望保存原本美丽的乡村，而贵公司一起发展。	大家都知道贵工厂为我们社区一直不断的努力让社区成长，但是我们还是希望保存原本美丽的乡村，和贵公司一起发展。
你买的书和ＣＤ都寄给我吧！我当当坐奖品给我的学生。	你买的书和ＣＤ都寄给我吧！我当当作奖品给我的学生。
老师们都会觉得很在意、很谨慎，可能他们会很难转住在教学的过程因为有摄影机。	老师们都会觉得很在意、很谨慎，可能他们会很难专注在教学的过程因为有摄影机。
世界上的环保问题上看来也造成环境污染，空气污染，乱费能力。	世界上的环保问题上看来也造成环境污染，空气污染，浪费能力。
他已经长大了，不只是个非常漂亮的女生，也超级聪明。	她已经长大了，不只是个非常漂亮的女生，也超级聪明。
看电影以前，张爱文想根林美美去吃饭。	看电影以前，张爱文想跟林美美去吃饭。
结果毕业之后找到的工作跟他们学的东西没有沈么关系。	结果毕业之后找到的工作跟他们学的东西没有什么关系。
老师常说：上课里面，别税觉。所以我们常觉得有一点累。	老师常说：上课里面，别睡觉。所以我们常觉得有一点累。
每个教室装影机是好的看法，影机对老师小心一点教学生，也对父母很担心。	每个教室装影机是好的看法，影机对老师小心一点教学生，也对父母很安心。
于现代社会男女平等的看法已普边了，并且，男女受到的教育程度也差不多了，如果这些女人结婚生子后都要离职的话，她们发挥自己能力的机会会也相对对得少了，就社会上算是个大的损失了。	于现代社会男女平等的看法已普遍了，并且，男女受到的教育程度也差不多了，如果这些女人结婚生子后都要离职的话，她们发挥自己能力的机会会也相对对得少了，就社会上算是个大的损失了。
我去劳工区讲是因为我家附近有这种的工厂不安全，会影响到我们的生活，就是每天我们已经收到声音跟不好的纹到阿，我们已经瘦不瞭呢，我好几只去跟他谈一谈，可是没有用呢，他一子说好呢我会处理，可是他都不处理，所以先在我才来这里请你没帮我处理那些事情啊，我不需要每天都有不好的事情怕生，先在我要求他做什么工作我不馆，什么想法我不馆，不要影响到我们的生活。	我去劳工区讲是因为我家附近有这种的工厂不安全，会影响到我们的生活，就是每天我们已经收到声音跟不好的味道啊，我们已经受不了了，我好几次去跟他谈一谈，可是没有用呢，他一直说好呢我会处理，可是他都不处理，所以现在我才来这里请你们帮我处理那些事情啊，我不需要每天都有不好的事情发生，现在我要求他做什么工作我不管，什么想法我不馆，不要影响到我们的生活。
那是他用很惊讶的语调说：「什么！」	那时他用很惊讶的语调说：「什么！」
天华谨上。	天华敬上。
我也知道家里附近有工厂的居民难免会收到一些影响但在合理规定范围内是可以接收的。	我也知道家里附近有工厂的居民难免会受到一些影响但在合理规定范围内是可以接受的。
最近厂长里面发出一种很难闻的味道，这种味道不知让我们村里的空气污染，而还让大家觉得害怕。	最近厂长里面发出一种很难闻的味道，这种味道不只让我们村里的空气污染，而还让大家觉得害怕。
当我老的时候我也希望女儿来照顾，而且经营公司，为我友好的未来，无论花多少时间，花多少钱，让我有好的教育再加上你都把你的一辈子来照顾我，我真理解你的想法。	当我老的时候我也希望女儿来照顾，而且经营公司，为我有好的未来，无论花多少时间，花多少钱，让我有好的教育再加上你都把你的一辈子来照顾我，我真理解你的想法。
所以家长应该很亲密的跟青少年谈话，给他时间可以上网运用网际网路的优点，获得资讯，跟各地的人交流，也提供给他时间，地方休息，看书，运动。	所以家长应该很亲密地跟青少年谈话，给他时间可以上网运用网际网路的优点，获得资讯，跟各地的人交流，也提供给他时间，地方休息，看书，运动。
如果不难改的话，我们去投诉政府的机关。	如果不能改的话，我们去投诉政府的机关。
所以我比较想推荐其他餐厅，就是一本导游书里面的餐厅。	所以我比较想推荐其他餐厅，就是一本导游书里面的餐厅。
我们真希望贵工厂能接受我们的意见，我们理会代表下礼拜一会访问您，那时候请给我们听听您们的看法好吗？	我们真希望贵工厂能接受我们的意见，我们里会代表下礼拜一会访问您，那时候请给我们听听您们的看法好吗？
所以，有机会应该多多休息。特别关心孩子，否测的话孩子就变成不好人。	所以，有机会应该多多休息。特别关心孩子，否则的话孩子就变成不好人。
妳是一个忒棒的人，一定要珍惜妳的生命。	妳是一个很棒的人，一定要珍惜妳的生命。
不知道你们有什么想法，但是对我来说这位校长的作法很好，她会听到家长们的声音。	不知道你们有什么想法，但是对我来说这位校长的做法很好，她会听到家长们的声音。
从没有噪音和臭味，为何你们的工厂最近会造出那么强列噪音与臭味呢？	从没有噪音和臭味，为何你们的工厂最近会造出那么强烈噪音与臭味呢？
我权大家不要勇者种方法来解决问题或给自己开心。	我劝大家不要用这种方法来解决问题或给自己开心。
２００８年１２月２号是我弟弟的些日。	２００８年１２月２号是我弟弟的生日。
相反的，目前全世界都出现了类似的趋势，唯一的区别是程度而已。	相反地，目前全世界都出现了类似的趋势，唯一的区别是程度而已。
我住在您的工厂附近，最近您工厂让人口附近有很都问题，包括我的家。	我住在您的工厂附近，最近您工厂让人口附近有很多问题，包括我的家。
下午四点，我跟林小姐去车站，让后坐车到西门去看电影。	下午四点，我跟林小姐去车站，然后坐车到西门去看电影。
因为家庭的经济情况不好，父母不能缴学费，所以孩子不能去上学校，我觉得这个问题是孩子没有关系，大人造成了非剧。	因为家庭的经济情况不好，父母不能缴学费，所以孩子不能去上学校，我觉得这个问题是孩子没有关系，大人造成了悲剧。
这几天过得好码？我看到你寄给我的信之后，非常担心妳，由于这次发生的事而心情不好。	这几天过得好吗？我看到你寄给我的信之后，非常担心妳，由于这次发生的事而心情不好。
我很著急合问她得吃药吗？她说不必吃药，可是应该多吃一点水果、多喝一点。	我很著急和问她得吃药吗？她说不必吃药，可是应该多吃一点水果、多喝一点。
我们约在台北１０１前面，好不好？六点可以马？请你星期六以前给我打电话。	我们约在台北１０１前面，好不好？六点可以吗？请你星期六以前给我打电话。
今天，李台生很早出们了。	今天，李台生很早出门了。
上课开始时，今天帮我忙的女生就到教室近来了。	上课开始时，今天帮我忙的女生就到教室进来了。
可以让孩子们一起发展、学习，同时父母可以继续工作，可避免沦落经济窘境，简直是一箭双雕。	可以让孩子们一起发展、学习，同时父母可以继续工作，可避免沦落经济窘境，简直是一箭双雕。
我们收到的影响很大还有很不好，觉得你一定同意。	我们受到的影响很大还有很不好，觉得你一定同意。
后来我朋友苦读了将近半年的书，考上了公务员！现在他们过的还不错。	后来我朋友苦读了将近半年的书，考上了公务员！现在他们过得还不错。
校院算是一个跟小朋友自我发展的地方。	校园算是一个跟小朋友自我发展的地方。
我准备一些面包给他吃，我也从冰箱拿出来了埤酒。	我准备一些面包给他吃，我也从冰箱拿出来了啤酒。
如果上学校的网路站就能看到教室里面，父母亲也可以知道孩子在学校学什么东西还可以再家里帮他们部。	如果上学校的网路站就能看到教室里面，父母亲也可以知道孩子在学校学什么东西还可以在家里帮他们补。
不好以时，我要给老师知道，明天我不会上课。	不好意思，我要给老师知道，明天我不会上课。
现在的老师们真不愿意自己负责教室里发生的坏事情，所以家长因该好好儿地看孩子，我认为这是摄影机最大的好处。	现在的老师们真不愿意自己负责教室里发生的坏事情，所以家长应该好好儿地看孩子，我认为这是摄影机最大的好处。
而且我觉得建设高速公路的好处是不至这一些，其实医疗方面、国防方面也有相当的意义。	而且我觉得建设高速公路的好处是不止这一些，其实医疗方面、国防方面也有相当的意义。
今天他学习的很愉快。	今天他学习得很愉快。
每个教师有自己的方法，但若家长干涉他，教师就勉强进行跟他不合适的教学法，这就是没有效果和效率。	每个教师有自己的方法，但若家长干涉他，教师就勉强进行跟他不合适的教学法，这就是没有效果和效率。
别迟到！我今天给你很多工课。你明天应该给我。你懂吗？	别迟到！我今天给你很多功课。你明天应该给我。你懂吗？
现在还有很多男女之间的冲突，两侧都一值主张自己的愿望，到真正的男女平等还差远了。	现在还有很多男女之间的冲突，两侧都一直主张自己的愿望，到真正的男女平等还差远了。
我觉得在学校哩，很安全的环境很重要。	我觉得在学校里，很安全的环境很重要。
我们夏天一起去欧洲玩，好不好？我想七月区最好吧。	我们夏天一起去欧洲玩，好不好？我想七月去最好吧。
他刚大学毕业了，年纪清，我相信天明相信他会很乐意的担任爸爸的职务。	他刚大学毕业了，年纪轻，我相信天明相信他会很乐意地担任爸爸的职务。
只可惜，因年级轻轻的他们，对现实生活的诱惑，加上是非不明，造成了另一些问题。	只可惜，因年纪轻轻的他们，对现实生活的诱惑，加上是非不明，造成了另一些问题。
有了监视器，父母可看到孩子在那一些方面需要改善而且也可以看到老师们对孩子的态度。	有了监视器，父母可看到孩子在哪一些方面需要改善而且也可以看到老师们对孩子的态度。
很多人都说再经过一两年，台湾的经济就会慢慢的变好，如果你坚持下去，保持乐观的态度，我保证你一定会得到好成果。	很多人都说再经过一两年，台湾的经济就会慢慢地变好，如果你坚持下去，保持乐观的态度，我保证你一定会得到好成果。
反而，您没有答应，我们就喝起来反对您。那么我们都很惨楼。那是我们都不希望发生的事情。	反而，您没有答应，我们就合起来反对您。那么我们都很惨啰。那是我们都不希望发生的事情。
好不容易睡著也到了凌晨被你们那儿的嗓音起床，总是睡眠不足，一天都没有精神。	好不容易睡著也到了凌晨被你们那儿的噪音起床，总是睡眠不足，一天都没有精神。
我一直以你骄傲，希望党像你伟大的人。	我一直以你骄傲，希望当像你伟大的人。
你也是美国人，随意你知道我们没有这样的学生组织制度。	你也是美国人，所以你知道我们没有这样的学生组织制度。
我们区民皆认为您方搬来我们社区后，同时在社区里出现具浓厚的臭味，由其在您工厂附近出现了浓黑色的污水、苍蝇、老鼠与许多的废弃物。	我们区民皆认为您方搬来我们社区后，同时在社区里出现具浓厚的臭味，尤其在您工厂附近出现了浓黑色的污水、苍蝇、老鼠与许多的废弃物。
父母都很忙，没有式建筑注意孩子的件况。	父母都很忙，没有时间去注意孩子的情况。
本来这二十个环境很好的地方，工厂的噪音影响到邻居们的生活，没有一个人可以受得了。	本来这儿是个环境很好的地方，工厂的噪音影响到邻居们的生活，没有一个人可以受得了。
他们谈著谈者就到了四点半。	他们谈著谈著就到了四点半。
因为他没有经验这方面，但是他们佣有了。	因为他没有经验这方面，但是他们拥有了。
虽然笔找到了也证明我的清白但整件事情会让我心理遭到伤痕呀！所以我很了解你现在的心情。	虽然笔找到了也证明我的清白但整件事情会让我心里遭到伤痕呀！所以我很了解你现在的心情。
我很幸庆我住宿时，父母亲没有买电脑给我，让我戒掉每天日夜不分的坐在电恼前的坏习惯。	我很幸庆我住宿时，父母亲没有买电脑给我，让我戒掉每天日夜不分地坐在电脑前的坏习惯。
祝您工作顺利！敬词！	祝您工作顺利！钦此！
从你来开这家工厂大家没有一天的安静生活像以前一样，很多人来跟你讲这件事情、底还是一样一点改变都没有。	从你来开这家工厂大家没有一天的安静生活像以前一样，很多人来跟你讲这件事情、你还是一样一点改变都没有。
但同时也发现座在我前面的同学遽然在作弊，而且不只是一个，是坐在那一区的一群人在一起作弊。	但同时也发现坐在我前面的同学居然在作弊，而且不只是一个，是坐在那一区的一群人在一起作弊。
现在的社会，女人地位已经不同了，不知你是否常看新闻，向台湾的政治人理，有吕修莲曾当了副总统，在学校里有很多知名老师都是女生。	现在的社会，女人地位已经不同了，不知你是否常看新闻，像台湾的政治人里，有吕秀莲曾当了副总统，在学校里有很多知名老师都是女生。
如果严重伤害自然环境，就不应该兴建一些工程（象苏华高速公路工程破坏环境条件）。	如果严重伤害自然环境，就不应该兴建一些工程（像苏花高速公路工程破坏环境条件）。
我发山发了六个小时。	我爬山爬了六个小时。
别感觉寄怪我为甚么问你这个问题，我想跟你一己出国，我智到你还没出过国，所以这是你一定要跟我一起。	别感觉奇怪我为甚么问你这个问题，我想跟你一起出国，我知道你还没出过国，所以这次你一定要跟我一起。
因为我工作最近很忙没有控，我不能去看你，对不起你。	因为我工作最近很忙没有空，我不能去看你，对不起你。
让小孩们自由对小孩的成长比较好，我觉得大人不要帮他们帮忙，不能我觉得学校得再考量他们的看法。	让小孩们自由对小孩的成长比较好，我觉得大人不要帮他们帮忙，不然我觉得学校得再考量他们的看法。
每个人都知道东部的台湾还有自然美欢迎不止台湾的观光客，每年也有不少外国观光客来参观。	每个人都知道东部的台湾还有自然美欢迎不只台湾的观光客，每年也有不少外国观光客来参观。
学校把学生交给老师教，小长应该信任老师。	学校把学生交给老师教，校长应该信任老师。
从星期一到星期五有要是下个周末你有时间，你就可以不可以帮我买这个点视机？	从星期一到星期五有要是下个周末你有时间，你就可以不可以帮我买这个电视机？
我有明天的工课，这个晚上请您给我打电话。	我有明天的功课，这个晚上请您给我打电话。
因为教室内安装摄影机有牵涉到老师，小孩及家长，我从此三个立场来表达上诉反对的理由。	因为教室内安装摄影机有牵涉到老师，小孩及家长，我从此三个立场来表达上述反对的理由。
他也不知道这么搭捷运，结果，大卫化了半个小时走来走去。	他也不知道这么搭捷运，结果，大卫花了半个小时走来走去。
他屋子的颜色比较奇怪，跟一个医院差不多一让。	他屋子的颜色比较奇怪，跟一个医院差不多一样。
你一直走到了第二个十子路口右专就到了。	你一直走到了第二个十字路口右转就到了。
下课以后他跟怒朋友上公车到别的地方去。公车理没有坐的地方所以他们得站著去。	下课以后他跟女朋友上公车到别的地方去。公车里没有坐的地方所以他们得站著去。
我再机场碰到了我五年前的高中同学。	我在机场碰到了我五年前的高中同学。
贵工厂的污水很废气先过滤后排出。	贵工厂的污水和废气先过滤后排出。
大明很刀剑，昨天我说跟你一起去可是今天我有事情在学校有考试。	大明很抱歉，昨天我说跟你一起去可是今天我有事情在学校有考试。
虽然是需要投资的，不过我们相信这不只是为了我们这些人做，而也是为了我们孩子，他们的孩子，也是为了保持我们唯一个自然环境。	虽然是需要投资的，不过我们相信这不只是为了我们这些人做，而也是为了我们孩子，他们的孩子，也是为了保持我们唯一的自然环境。
请考卢工厂的运营，处理一下这些问题。	请考虑工厂的运营，处理一下这些问题。
放假快要来了，暱友打算吗？	放假快要来了，你有打算吗？
考试一后，我们再学校门口见面，然后我们可以一起去吃饭。	考试以后，我们在学校门口见面，然后我们可以一起去吃饭。
很多时候这些行为会影响到他们健康的心理成长过程，他们分不清虚拟的网路世界语真实生活的界线。	很多时候这些行为会影响到他们健康的心理成长过程，他们分不清虚拟的网路世界与真实生活的界线。
我的家住在这里已经有了２０多年，大家对于这个地方的环保很满意，从老人到小朋友都很了解「环保」的这瞭个字。	我的家住在这里已经有了２０多年，大家对于这个地方的环保很满意，从老人到小朋友都很了解「环保」的这两个字。
下个周末，我一个人到山上去发山。	下个周末，我一个人到山上去爬山。
针对上面所提出的问题，通过跟居民们的讨论，我们有几个处里的方案提供您参考。	针对上面所提出的问题，通过跟居民们的讨论，我们有几个处理的方案提供您参考。
现在是２１世纪，是公商业化，现代化，全世界都用经济来做标准，经济发展那国才是发展国家，经济发展交通也会发展，你果想要发展，交通得发展，人民的生活才会进步。	现在是２１世纪，是工商业化，现代化，全世界都用经济来做标准，经济发展那国才是发展国家，经济发展交通也会发展，你果想要发展，交通得发展，人民的生活才会进步。
他们正在还在电影院一边看电影一边聊天，高兴的不得了。	他们正在还在电影院一边看电影一边聊天，高兴得不得了。
我本身觉得有不小心而得罪他。这样是去他的信任，才会光怪妳作从来没有犯过的错。	我本身觉得有不小心而得罪他。这样是去他的信任，才会光怪妳做从来没有犯过的错。
他的床很小，是蓝的也是录的。	他的床很小，是蓝的也是绿的。
第一位跟第二位说：情坐。	第一位跟第二位说：请坐。
这个对父母来说是一个很好的办法因为父母不用一直担心他们孩子的件况。	这个对父母来说是一个很好的办法因为父母不用一直担心他们孩子的情况。
我们都超爱喝埤酒。	我们都超爱喝啤酒。
还有学语言的时候，以前都是用字典来查，现在他们都用上网来查。如果到一个地方没有网路那个人这么办。	还有学语言的时候，以前都是用字典来查，现在他们都用上网来查。如果到一个地方没有网路那个人怎么办。
有的小孩她不想这个学校但是父母偏偏避他们一定要念这所学校，造成他们不喜欢念，如果念只是一个任务罢了。	有的小孩她不想这个学校但是父母偏偏逼他们一定要念这所学校，造成他们不喜欢念，如果念只是一个任务罢了。
对我印象最深刻的是金融危机的那时候，一个人员都没开出，而从自己的口袋里掏出钱来过这救我们的公司并很多就业机会。	对我印象最深刻的是金融危机的那时候，一个人员都没开除，而从自己的口袋里掏出钱来过这救我们的公司并很多就业机会。
我上个月差一点老板解雇，是应为我忙了准备结婚想给老婆有美好的生活，好几迟到，我还把公司的财务算错了，三心二意幸好没事。	我上个月差一点老板解雇，是因为我忙了准备结婚想给老婆有美好的生活，好几迟到，我还把公司的财务算错了，三心二意幸好没事。
长的岁月走了，孩子已经长大了，先生的职位高了，有是后我的心理空虚，不高兴。	长的岁月走了，孩子已经长大了，先生的职位高了，有时候我的心里空虚，不高兴。
有的人中事经济发展，有的人反对还憬坡怀。那谁的想法对吗？	有的人重视经济发展，有的人反对环境破坏。那谁的想法对吗？
我们在靠东西，还没完在下雨有一点不好，可是我觉得还很高兴、很有意思。	我们在烤东西，还没完在下雨有一点不好，可是我觉得还很高兴、很有意思。
等你好了一起去钓鱼好吗？你一订要快好。	等你好了一起去钓鱼好吗？你一定要快好。
现在独立生活的人有越来越增加的趋势，因一个人的生活实在太寂漠了，孤独而要以养宠物来做陪伴的人也跟著增加了。	现在独立生活的人有越来越增加的趋势，因一个人的生活实在太寂寞了，孤独而要以养宠物来做陪伴的人也跟著增加了。
我爸爸想找新的工作，不过他没有甚么一枝之长，也不太会打电脑，所以找新的工作好像很难。	我爸爸想找新的工作，不过他没有甚么一技之长，也不太会打电脑，所以找新的工作好像很难。
他都打半夜的工，所以白天很少出门，到周末找些外面的朋友闹。	他都打半夜的工，所以白天很少出门，到周末找些外面的朋友闹。
这样也可以帮父母了解孩子的件况，他们对什么还有问题，所以父母可以鼓励孩子。	这样也可以帮父母了解孩子的情况，他们对什么还有问题，所以父母可以鼓励孩子。
我听说你要开一个庆祝庆祝地会，可是那天我有一件很重要的事情一定不能参加。	我听说你要开一个庆祝庆祝的会，可是那天我有一件很重要的事情一定不能参加。
我的时间不再，所以还没看到他。	我的时间不在，所以还没看到他。
我的头有疑点藤。	我的头有一点疼。
我们不但可以选我们所以爱的小狗，而且若养不喜欢还可以换别种的小狗。	我们不但可以选我们所喜爱的小狗，而且若养不喜欢还可以换别种的小狗。
学生之间也难免有很多纠纷或是巴陵的行为，摄影机可以帮助被欺负的学生拿出证据保护自己权利。	学生之间也难免有很多纠纷或是霸凌的行为，摄影机可以帮助被欺负的学生拿出证据保护自己权利。
我跟你去吃台湾午饭，欢迎你跟我来！	我跟你去吃台湾晚饭，欢迎你跟我来！
结果过了两天他就拿钱来给我，一直笑我哪时候我才发现他在跟我开玩笑的，我比较不生气了。	结果过了两天他就拿钱来给我，一直笑我那时候我才发现他在跟我开玩笑的，我比较不生气了。
此外，当个家庭主妇有多好处根乐趣。	此外，当个家庭主妇有多好处跟乐趣。
不过也有可能你跟他之间曾经由莫一种事情让你们之间造成了一些对彼此之间的误会甚么的，使他竟然误会无辜的你。	不过也有可能你跟他之间曾经由某一种事情让你们之间造成了一些对彼此之间的误会甚么的，使他竟然误会无辜的你。
一个人是大名跟他的奴生的朋友，她们很票亮。	一个人是大明跟他的女生的朋友，她们很漂亮。
再请您看了这封信，就回答我。	在请您看了这封信，就回答我。
王天华是她班最快的学生，天花很高兴，所以今天晚上她跟他的同学一起去长卡拉ＯＫ。	王天华是她班最快的学生，天华很高兴，所以今天晚上她跟他的同学一起去唱卡拉ＯＫ。
校院哩，小朋友们会很自然的学会因果关系、问题解决方法与人际关系。	校园里，小朋友们会很自然的学会因果关系、问题解决方法与人际关系。
他们要坐公车去野餐，等公车的时候，他们都高高兴兴地说今天得计划。	他们要坐公车去野餐，等公车的时候，他们都高高兴兴地说今天的计划。
我跟你说，你一个礼拜只上两天办，那你要不要看一下在其他时间打工下下。	我跟你说，你一个礼拜只上两天班，那你要不要看一下在其他时间打工下下。
因为我主过好几个国家包括北美洲、非洲、亚洲、跟一些在太平洋的小岛，这种充分不同文化的经验使我知道没有一个人的想法完全对，也没有一个社会的观念是完全对。	因为我住过好几个国家包括北美洲、非洲、亚洲、跟一些在太平洋的小岛，这种充分不同文化的经验使我知道没有一个人的想法完全对，也没有一个社会的观念是完全对。
他们把雪要的东西准备好了就坐二九七号公车。	他们把需要的东西准备好了就坐二九七号公车。
一个小姐叫他怎么去，她跟他说「这里离大学很远，你最好要坐公车。」	一个小姐教他怎么去，她跟他说「这里离大学很远，你最好要坐公车。」
随著经济的飞跃得发展，每个国家都会冲突经济和环保的问题。	随著经济的飞跃的发展，每个国家都会冲突经济和环保的问题。
小王问她：「对不气，你叫什么名字？」	小王问她：「对不起，你叫什么名字？」
我觉得很放便，我们也可以看电视的棒球，我们都很喜欢棒球，因为小的时候我们每天打棒球。	我觉得很方便，我们也可以看电视的棒球，我们都很喜欢棒球，因为小的时候我们每天打棒球。
上个星期，我的电视机怀了，我要买新的。	上个星期，我的电视机坏了，我要买新的。
我希望可以受到你的回信，内容时关于这件问题的。	我希望可以收到你的回信，内容是关于这件问题的。
我想这是因为他们还没有碰过外国人的关西，或是发现他们是故意想要欺负的话，就想成他们是不懂事的小朋友，可怜他们。	我想这是因为他们还没有碰过外国人的关系，或是发现他们是故意想要欺负的话，就想成他们是不懂事的小朋友，可怜他们。
在某一家私立国小，每一个教室里有摄影机。为何呐？因为学校想提供给家长机去看一下教室里面的状况与他们小朋友的行为。	在某一家私立国小，每一个教室里有摄影机。为何呢？因为学校想提供给家长机去看一下教室里面的状况与他们小朋友的行为。
他觉得上山很容易，没有痕累，所以他没有什么都准备。	他觉得上山很容易，没有很累，所以他没有什么都准备。
我下个星期天我妈妈回来台湾。	我下个星期天我妈妈会来台湾。
在日本也很多青少年爱上网。有些人上网中毒了不能停上网。而且很多青少年在上网收了不好的影响。	在日本也很多青少年爱上网。有些人上网中毒了不能停上网。而且很多青少年在上网受了不好的影响。
有可能牠的心理受到伤害，也有可能以后不能相心人。	有可能牠的心理受到伤害，也有可能以后不能相信人。
简单来讲，先马铃薯，洋葱，红萝卜炒以炒，加汤汁，牛肉，小匙糖，酱油，甜料酒，煮到马铃薯软就可以。	简单来讲，先马铃薯，洋葱，红萝卜炒一炒，加汤汁，牛肉，小匙糖，酱油，甜料酒，煮到马铃薯软就可以。
所以如果说对他们的心理的影响，可说没什么障碍舆忧虑。	所以如果说对他们的心理的影响，可说没什么障碍与忧虑。
请全公司的职员一起负担公司的危机。机的经纪状况转好而复苏，这些你们的功劳一定是会报恩你们的。	请全公司的职员一起负担公司的危机。机的经济状况转好而复苏，这些你们的功劳一定是会报恩你们的。
我也希望不是为了这个小是让你们那边和我们这边都会损失财物、精神、关系。	我也希望不是为了这个小事让你们那边和我们这边都会损失财物、精神、关系。
在台湾我第一次忍识那么从别的国家来的人，而且从来没有主再说中文的环境，所以过不了机天我就开始想家人了。	在台湾我第一次认识那么从别的国家来的人，而且从来没有住在说中文的环境，所以过不了几天我就开始想家人了。
按照我，教育部门或者每个父母需要找合理的办法，父母肯定知道对他们自己的孩子哪一种意建是最合适的。	按照我，教育部门或者每个父母需要找合理的办法，父母肯定知道对他们自己的孩子哪一种意见是最合适的。
但是有一些父母范对自己孩子去打工，这些父母怕打工影响孩子的学习。	但是有一些父母反对自己孩子去打工，这些父母怕打工影响孩子的学习。
我们还有很多办法可以处理你的工厂，你该听过「你敬人一尺人敬你一长了吧！」要是你尊重我们我们也会尊重你的。	我们还有很多办法可以处理你的工厂，你该听过「你敬人一尺人敬你一丈了吧！」要是你尊重我们我们也会尊重你的。
在学校林美美的傍边的位子是张爱文。	在学校林美美的旁边的位子是张爱文。
我代表说有住在你工厂附近的人民先说一声感谢，你的工厂的存在已经对我们这些人民带了不少的帮忙。	我代表所有住在你工厂附近的人民先说一声感谢，你的工厂的存在已经对我们这些人民带了不少的帮忙。
所以你要想一想那一些工作比较适合你。我们要一起加油，还年轻麻、不可以让这件小小事情打破我们。	所以你要想一想哪一些工作比较适合你。我们要一起加油，还年轻嘛、不可以让这件小小事情打破我们。
学校也需要更多投资在教义的方面。希望未来小学的教义能更好，出了更好的学生。	学校也需要更多投资在教育的方面。希望未来小学的教义能更好，出了更好的学生。
连我也不知道我妈妈那些年日子大地是怎么过的。他心里在想甚么。他会不会觉得这个情况有点点不公平。	连我也不知道我妈妈那些年日子到底是怎么过的。她心里在想甚么。她会不会觉得这个情况有点点不公平。
您知不知道如果工厂的声音太吵，还要有非常不好的味道，臭臭的味道让他家不能呼吸很好的空气。	您知不知道如果工厂的声音太吵，还要有非常不好的味道，臭臭的味道让大家不能呼吸很好的空气。
不然你永远会被自己的情绪拉著走，而呼略了事情的问题出在那里。	不然你永远会被自己的情绪拉著走，而忽略了事情的问题出在那里。
慢慢慢慢地我可能会变成各不敢说话的人也不敢做甚么事、只因为怕别人批评。	慢慢慢慢地我可能会变成个不敢说话的人也不敢做甚么事、只因为怕别人批评。
下车后他们热心的没话说了，因为哪个地方非常好。	下车后他们热心地没话说了，因为那个地方非常好。
你说得没错你还是算很辛运，我阿根廷的朋友们更痛苦。	你说得没错你还是算很幸运，我阿根廷的朋友们更痛苦。
如果你想要去的话，你需要带两个礼拜的衣服，应为我们会在哪里玩两个礼拜。	如果你想要去的话，你需要带两个礼拜的衣服，因为我们会在那里玩两个礼拜。
我看看我手上如果有适合你做的案子，我会把它交给你，赚点外块。	我看看我手上如果有适合你做的案子，我会把它交给你，赚点外快。
我希望你赶快坚固起来，我会去的时候好好的见面。	我希望你赶快坚固起来，我回去的时候好好的见面。
那家餐厅是吃到饱的餐厅，所以我感在哪里吃饭。	那家餐厅是吃到饱的餐厅，所以我改在哪里吃饭。
想吃吃看这些东西，你最好九月低过来，跟我一起去慕尼黑的「啤酒节」。	想吃吃看这些东西，你最好九月底过来，跟我一起去慕尼黑的「啤酒节」。
在使用时，我都先作好我的作业然后再看新闻或是玩个小游戏。	在使用时，我都先做好我的作业然后再看新闻或是玩个小游戏。
清您别担心我们的态度。我们大家希望这件事会好好的处理，不要给所有的人压力！	请您别担心我们的态度。我们大家希望这件事会好好的处理，不要给所有的人压力！
今天我写信给您是因为想掰秃您！您的工厂最近又吵和臭味让我都受不了，因为会影潘响到我们的生活。	今天我写信给您是因为想拜托您！您的工厂最近又吵和臭味让我都受不了，因为会影潘响到我们的生活。
明天是里拜天我想请你跟我一起出去玩。	明天是礼拜天我想请你跟我一起出去玩。
上个月我座飞机到加拿大去了。	上个月我坐飞机到加拿大去了。
虽然也有好处，但不可能只有好处，我们的秘密也会落出来！	虽然也有好处，但不可能只有好处，我们的秘密也会露出来！
测天王天华很早就打电话约李大明昨天下午两点到他家一起看比赛。	这天王天华很早就打电话约李大明昨天下午两点到他家一起看比赛。
对学生来说，可能如果父母一直看到他们，一边让孩子不能独立，以便让孩子觉得念书的时候他们有很多压力。	对学生来说，可能如果父母一直看到他们，一边让孩子不能独立，一边让孩子觉得念书的时候他们有很多压力。
最近，我觉得很累，生活台我无聊。	最近，我觉得很累，生活太过无聊。
请您们也换一个到工厂的垃圾不然把那个地方封住让味道不出来也不要找成民主的困扰及不舒服。	请您们也换一个到工厂的垃圾不然把那个地方封住让味道不出来也不要造成邻居的困扰及不舒服。
这乃因为过早授予孩童类似幼儿园抑或学校或政府所设定的教育方程式，会导致孩童的心智发展被局限于一种无法发挥的框框里。	这乃因为过早授予孩童类似幼儿园亦或学校或政府所设定的教育方程式，会导致孩童的心智发展被局限于一种无法发挥的框框里。
我觉得你应该也吃药也休息机天就好了。	我觉得你应该也吃药也休息几天就好了。
至于这些书和光碟，你可以让书局邦你卖；或者我们会问我们的朋友谁可以帮我们卖，好吗！	至于这些书和光碟，你可以让书局帮你卖；或者我们会问我们的朋友谁可以帮我们卖，好吗！
我们到法国去，好不好？那个时候法过都去海边放假，所以在巴黎城市人不太多。	我们到法国去，好不好？那个时候法国都去海边放假，所以在巴黎城市人不太多。
请你快告诉我你愿不原意跟我一起去。	请你快告诉我你愿不愿意跟我一起去。
所以我十份支持小学的学校有装摄影机、因为我觉得能把自己小孩教好比什么都重要。	所以我十分支持小学的学校有装摄影机、因为我觉得能把自己小孩教好比什么都重要。
马英九的中学给学生很他的困难，但马英九觉得没关系。	马英九的中学给学生很多的困难，但马英九觉得没关系。
因为我不能参家你的舞会所以我要请你跟我去吃晚饭再看电影。	因为我不能参加你的舞会所以我要请你跟我去吃晚饭再看电影。
不过这是我也有错，所以不能说跟你一样的情行。	不过这是我也有错，所以不能说跟你一样的情形。
我要座得巴士是７１６。	我要坐的巴士是７１６。
格位学生的父母，您门好。	各位学生的父母，您们好。
我希望你的身体好了可是如果我的冰就好了快到了，我一定马上去你的珈和给你礼遇。	我希望你的身体好了可是如果我的病就好了快到了，我一定马上去你的家和给你礼遇。
我纲来学校的时候，林美美请我帮她做她的功课。	我刚来学校的时候，林美美请我帮她做她的功课。
晚上七八点才回家，希望可以好好休息，但是，回到家听到你们广场传来的声音，真的非常生气。	晚上七八点才回家，希望可以好好休息，但是，回到家听到你们工厂传来的声音，真的非常生气。
我们希望工厂的时间改一下可以吗？晚上不要动比较好一点，早上的时你们考卢。	我们希望工厂的时间改一下可以吗？晚上不要动比较好一点，早上的时你们考虑。
我应该无聊的玩笑适是而止。	我应该无聊的玩笑适时而止。
早上到晚上，天天都太噪，让附近的孩子们不睡觉。	早上到晚上，天天都太吵，让附近的孩子们不睡觉。
以前用电话跟朋友聊天，常常妈妈叫我们刚快挂电话，因为需要很多电话费。	以前用电话跟朋友聊天，常常妈妈叫我们赶快挂电话，因为需要很多电话费。
例如年轻人开始晚上不睡觉打电玩进而影像到明天上课的精神，或是长期在电脑前面注视著荧幕变成近视儿童。	例如年轻人开始晚上不睡觉打电玩进而影响到明天上课的精神，或是长期在电脑前面注视著荧幕变成近视儿童。
在那时后，有一些我在教会认识的兄弟姊妹有来过我们家，谈谈我那时后的家里状况。	在那时候，有一些我在教会认识的兄弟姊妹有来过我们家，谈谈我那时后的家里状况。
我看你从来都没有休息的时间，正天都是工作的。	我看你从来都没有休息的时间，整天都是工作的。
您盖工厂的时候，已经跟住在这儿附近的邻居们撘应得好好的处理环境的问题。	您盖工厂的时候，已经跟住在这儿附近的邻居们答应得好好的处理环境的问题。
没问题，那你去把！	没问题，那你去吧！
我觉得上网就跟咖啡因瘾一样，一旦喜欢上那个感觉，就很难脱身。	我觉得上网就跟咖啡因瘾一样，一但喜欢上那个感觉，就很难脱身。
新爱父亲。	亲爱父亲。
这样不但您的市场走比较高的工作销路，而界我们也受惠。	这样不但您的市场走比较高的工作效率，而且我们也受惠。
虽然我多理解你的想法，但我个人已经有了自己的人生计划。	虽然我都理解你的想法，但我个人已经有了自己的人生计划。
爸爸刚开始也和你现在一样，但是因为妈妈，家人的鼓励和支持，爸爸还是努力的找寻新工作。	爸爸刚开始也和你现在一样，但是因为妈妈，家人的鼓励和支持，爸爸还是努力地找寻新工作。
我知道在台湾有一个地旁很美，就是淡水，那里有很多东西很好吃，又友山有水，很漂亮。	我知道在台湾有一个地方很美，就是淡水，那里有很多东西很好吃，又有山有水，很漂亮。
拿著地图，背著包勇敢得问学校的地址。	拿著地图，背著包勇敢地问学校的地址。
张爱文和林美美不能一起去那理。	张爱文和林美美不能一起去那里。
其实这件问题我已经经过了。我的事情那时后就是比你现在很惨喽。	其实这件问题我已经经过了。我的事情那时候就是比你现在很惨喽。
下次若在发生类似的事件的话，必须要冷静处理，将双方可能受到的伤害减到最低。	下次若再发生类似的事件的话，必须要冷静处理，将双方可能受到的伤害减到最低。
这是很特别，应为我自己作饭。	这是很特别，因为我自己作饭。
我昨天下了课以后，就马上回家、洗脸，延后打算自己做饭。	我昨天下了课以后，就马上回家、洗脸，然后打算自己做饭。
我下个礼拜五要回国了想请你吃个晚餐、聊聊天，不知道你这个礼拜天有没有控呢？	我下个礼拜五要回国了想请你吃个晚餐、聊聊天，不知道你这个礼拜天有没有空呢？
在加上你以前不是说要减肥吗？那么，这就是你的好机会，运动也是一件免费的事啊。	再加上你以前不是说要减肥吗？那么，这就是你的好机会，运动也是一件免费的事啊。
谢谢你的协作。祝您保重。	谢谢你的协助。祝您保重。
上周四早上，我一如往常的至住家附近的顶好超市买菜。	上周四早上，我一如往常地至住家附近的顶好超市买菜。
这种面包的外面是白色的，是差不多高两公高的，也有糖在里面。冬天，面包点都卖。	这种面包的外面是白色的，是差不多高两公高的，也有糖在里面。冬天，面包店都卖。
应为以我来看小孩子不管多么认真，活泼，校长都没有权力控制他们的自由。	因为以我来看小孩子不管多么认真，活泼，校长都没有权利控制他们的自由。
我想要去加拿大玩，应为有和多好吃的。	我想要去加拿大玩，因为有很多好吃的。
我那时不知所措，蒙然大哭。	我那时不知所措，猛然大哭。
所以他很快洗澡然后走路到公车占。	所以他很快洗澡然后走路到公车站。
反弹的是那些印呢富翁，把他们的后代送到国外受高学历。	反弹的是那些印尼富翁，把他们的后代送到国外受高学历。
因为她也想看这部电影，所以她马上就回答我：「好啊，我也想看这部电影。」我们下了课就打公车去西门町。	因为她也想看这部电影，所以她马上就回答我：「好啊，我也想看这部电影。」我们下了课就搭公车去西门町。
美国现在很冷，请办我买件雪衣。	美国现在很冷，请帮我买件雪衣。
他有一个女朋友叫美美。他们今天打篹一起去看电影。	他有一个女朋友叫美美。他们今天打算一起去看电影。
因为德国的天气不是这么热的，也不太施。	因为德国的天气不是这么热的，也不太湿。
一个人成长好相跟一根树，主要是给他们够基本条间，它会长的很快。	一个人成长好像跟一根树，主要是给他们够基本条件，它会长的很快。
直到我大概到了高中，才有慢慢的接触和认识到这些高科技的东西。	直到我大概到了高中，才有慢慢地接触和认识到这些高科技的东西。
因为有不少人在大成市比如说纽约，他们是一个人住、没有家人所以有时后他们很孤单、有时候觉得自己很寂寞。	因为有不少人在大城市比如说纽约，他们是一个人住、没有家人所以有时后他们很孤单、有时候觉得自己很寂寞。
不但空气现在连我们用的泉水也有了未到，著一些你嫩一定要有责任处理，至少的是要设计处理费。	不但空气现在连我们用的泉水也有了味道，这一些你们一定要有责任处理，至少的是要设计处理费。
李长厂您可以检查如果这公司的作势适合您工厂。	李长厂您可以检查如果这公司的做事适合您工厂。
他告诉我他现在读书在台湾大学，他雪地里。	他告诉我他现在读书在台湾大学，他学地理。
这个事情一般是我们最喜欢的享受，我们不是看辕动比赛，就是在辕动场玩球。	这个事情一般是我们最喜欢的享受，我们不是看运动比赛，就是在运动场玩球。
你的身体什么样？你生什么病了？	你的身体怎么样？你生什么病了？
作天，我爬山，空气好还有看法很漂亮。	昨天，我爬山，空气好还有看法很漂亮。
我觉得这的发现农药的话，人最重要的是人们要知道这个事实。	我觉得真的发现农药的话，人最重要的是人们要知道这个事实。
我看他的时候我很高心，因为上子我看他是一年以前。	我看他的时候我很高兴，因为上次我看他是一年以前。
把错与对先放一边，确切的了解问题之后，才能想出解决的方案。	把错与对先放一边，确切地了解问题之后，才能想出解决的方案。
总之希望你不要太难过，乐观依点。	总之希望你不要太难过，乐观一点。
所以你不用担心经气会慢慢好起来的。大明阿你要加油。自己要努力才能成功	所以你不用担心景气会慢慢好起来的。大明啊你要加油。自己要努力才能成功
要是没有达应、我们不愿意也没有办法去政府哩的卫生局谈这些问题。	要是没有答应、我们不愿意也没有办法去政府里的卫生局谈这些问题。
老师跟大明说：「已经几点了你才来学校？」，大明怎不好意事。	老师跟大明说：「已经几点了你才来学校？」，大明真不好意思。
我们早上集合，大家都带很多东西，然后座公车大概１５分钟就到了烤肉的地方。	我们早上集合，大家都带很多东西，然后坐公车大概１５分钟就到了烤肉的地方。
我非常的支持半工半读。虽然有点辛苦，但获得的东西以及喜悦是两倍三倍的。	我非常地支持半工半读。虽然有点辛苦，但获得的东西以及喜悦是两倍三倍的。
他等一下，户然他看到一辆汽车。	他等一下，忽然他看到一辆汽车。
你知不知得，有一对很久一直就在这里的爷奶呢？为了你的作业场他们最近搬家了。	你知不知道，有一对很久一直就在这里的爷奶呢？为了你的作业场他们最近搬家了。
我当时匆匆忙忙得银行生活，在两个月内就变得很悠闲，每天默默的待在家里电话旁，等待银行来电。	我当时匆匆忙忙的银行生活，在两个月内就变得很悠闲，每天默默地待在家里电话旁，等待银行来电。
他现在哈尔夫大学管理学院念硕士班。	她现在哈尔夫大学管理学院念硕士班。
比如说，不想要去学校的孩子因该比较少。	比如说，不想要去学校的孩子应该比较少。
因为我注在秘鲁的奶奶生病得很严重。	因为我住在秘鲁的奶奶生病得很严重。
我非常清出地看到，除了家庭之外公司对你来讲是你的生活最重要的一件事。	我非常清楚地看到，除了家庭之外公司对你来讲是你的生活最重要的一件事。
政府可以化多点钱，把高速公路弯过去是最好的方法。	政府可以花多点钱，把高速公路弯过去是最好的方法。
认识你这么多年了，我知到你很有才分与经验，也知道你对你现在的工作有感到兴趣。	认识你这么多年了，我知道你很有才分与经验，也知道你对你现在的工作有感到兴趣。
积极力邀公司上下各阶层来开会检讨何改进现有的营运模式和型态。	积极力邀公司上下各阶层来开会检讨和改进现有的营运模式和型态。
因为孩子跟妈妈有特别的关系，妈马教什么孩子学什么。	因为孩子跟妈妈有特别的关系，妈妈教什么孩子学什么。
我要先说你恭喜的话，应为我者到现在很难找到工作，所以很棒。	我要先说你恭喜的话，因为我知道现在很难找到工作，所以很棒。
然后为了孩子中午可以睡觉以下，请你让你的工人最少休息１个钟头。	然后为了孩子中午可以睡觉一下，请你让你的工人最少休息１个钟头。
汽车所使用的油对地球排放的物染必要负责的是７０％，温室效应正在毁灭我门的地球。	汽车所使用的油对地球排放的污染必要负责的是７０％，温室效应正在毁灭我们的地球。
在家中父母亲每天要安排时将跟孩子沟通，让多了解他们的事情。	在家中父母亲每天要安排时间跟孩子沟通，让多了解他们的事情。
那是，有一个小姐走进来，他就把一张地图拿过这位小姐问路。	那时，有一个小姐走进来，他就把一张地图拿过这位小姐问路。
父母要有一个看法，就是装摄影机只是让他们了解孩子的情况，然后找办法去帮他，却不是一种管孩子的作法。	父母要有一个看法，就是装摄影机只是让他们了解孩子的情况，然后找办法去帮他，却不是一种管孩子的做法。
我来台弯要学中文，因为中文很从邀。	我来台湾要学中文，因为中文很重要。
我已经自己能到公馆捷运站了，可是看地图也都看不懂怎吗去学校	我已经自己能到公馆捷运站了，可是看地图也都看不懂怎么去学校
必老师改他的教法	逼老师改他的教法
我是家庭主妇，育有三个孩子，先生在中华电信担任课服人员。	我是家庭主妇，育有三个孩子，先生在中华电信担任客服人员。
我很想要去看你，不过我最近工作太忙不能去，希望你快回复。	我很想要去看你，不过我最近工作太忙不能去，希望你快恢复。
可是如果父母支持校长用摄影机来观擦孩子的一举一动，用这种方式来去了解他们，那也太慌妙了。	可是如果父母支持校长用摄影机来观察孩子的一举一动，用这种方式来去了解他们，那也太荒谬了。
从我的生日会以来，我们很久没见面，所以我恨高兴！	从我的生日会以来，我们很久没见面，所以我很高兴！
当老师要了解学生，当父母要了解孩子，他个性如个？他喜欢什么，不喜欢什么？	当老师要了解学生，当父母要了解孩子，他个性如何？他喜欢什么，不喜欢什么？
大明要跟她的男朋友一块完。	大明要跟她的男朋友一块玩。
你现在每星期放假三天，加上周末就是五天能自己利用。	你现在每星期放假三天，加上周末就是五天能自己利用。
假如哪天你是被丢书包的人呢你会怎么办呢，你会向他一样这么做吗，还是有其他办法呢。	假如哪天你是被丢书包的人呢你会怎么办呢，你会像他一样这么做吗，还是有其他办法呢。
这几年以来我们国家的经济退步的很厉害，各个商家一落千丈，失业禄越来越高，每个人都不在乎可铃多少薪水，可找到工作就行了。	这几年以来我们国家的经济退步的很厉害，各个商家一落千丈，失业率越来越高，每个人都不在乎可领多少薪水，可找到工作就行了。
情爱的朋友。	亲爱的朋友。
起点五十分公车来了，可是公车里很多人，好像进不去。	七点五十分公车来了，可是公车里很多人，好像进不去。
如果有问题的话家长可以告诉校长，所以他可以跟老师说话他们因该这么样当老师，这么样的好好地教学生，这么样做好玩学的情况，所以让他家用功练习。	如果有问题的话家长可以告诉校长，所以他可以跟老师说话他们应该怎么样当老师，怎么样的好好地教学生，这么样做好玩学的情况，所以让大家用功练习。
谁知道，明天来上课的时候，她会主动想跟你关系合好。	谁知道，明天来上课的时候，她会主动想跟你关系和好。
最重要是如果爸妈真的自己去看真真的情况怎么样？才你了解自己的孩子。	最重要是如果爸妈真的自己去看真正的情况怎么样？才你了解自己的孩子。
不只是在家外面，联谊精密避的家里面也会闻到臭味。	不只是在家外面，连已经密闭的家里面也会闻到臭味。
我很高兴因为可以写下来你。我跟很多朋友开会。甚么是？星期天早上八点半。	我很高兴因为可以写信来你。我跟很多朋友开会。甚么事？星期天早上八点半。
对不起，我们下星期再去看，好不好？请你了结我只好这样做。	对不起，我们下星期再去看，好不好？请你了解我只好这样做。
我们也有一支狗。	我们也有一只狗。
你说要跟朋友合作开供应各国食物餐厅？好注意！	你说要跟朋友合作开供应各国食物餐厅？好主意！
我写这丰电子邮件问你，现在你的身体怎么样了？	我写这封电子邮件问你，现在你的身体怎么样了？
孩子们也就是人，在教室一直意职别人、没有信心的话，这样不算教育。	孩子们也就是人，在教室一直意识别人、没有信心的话，这样不算教育。
我应该告诉你为什么不能按照你的意思去做，是因为我最近找到一个大工。	我应该告诉你为什么不能按照你的意思去做，是因为我最近找到一个打工。
其实我们很多时候，不是完全能够空只资鸡的行为和感受的。	其实我们很多时候，不是完全能够控制自己的行为和感受的。
后来我回想以下就有倚重幽灵一般的问候出现：「值日生」是什么？	后来我回想以下就有一种幽灵一般的问候出现：「值日生」是什么？
而解环境问题不只是台湾才有，每个国家都有。	而且环境问题不只是台湾才有，每个国家都有。
也许老师可以把录音给父母看，所以他们知道他们的孩子这么样，也是这么样教他们的孩子。	也许老师可以把录影给父母看，所以他们知道他们的孩子怎么样，也是怎么样教他们的孩子。
本来这间公司遭遇经济上的困境时，出了倒闭以外没有其他的方法了。	本来这间公司遭遇经济上的困境时，除了倒闭以外没有其他的方法了。
虽然家长不能直接打扰老师在教书的时候，可是老师也会有一个默默被主义的压力。	虽然家长不能直接打扰老师在教书的时候，可是老师也会有一个默默被注意的压力。
我们可以亲眼看到上课发现什么事，就不用疑为我们的孩子或者他的老师。	我们可以亲眼看到上课发现什么事，就不用以为我们的孩子或者他的老师。
我家以两百公尺的距离还听到，可想像到住工厂隔壁的邻居要如何忍受。	我家离两百公尺的距离还听到，可想像到住工厂隔壁的邻居要如何忍受。
还没说道还很小的小朋友，天天没好好的念书，一下课就马上上网，连吃饭和洗澡都不要做。	还没说到还很小的小朋友，天天没好好地念书，一下课就马上上网，连吃饭和洗澡都不要做。
当然这个有一些好处可是我觉得这个作法对孩子们总共不好。	当然这个有一些好处可是我觉得这个做法对孩子们总共不好。
虽然服用药单市我们还在呼吸外面的空气、也还在接处赃的东西、怎么可以容易治疗呢？	虽然服用药但是我们还在呼吸外面的空气、也还在接触脏的东西、怎么可以容易治疗呢？
我从德国莱，可是我的妈妈是台湾人。	我从德国来，可是我的妈妈是台湾人。
我知道去年卫生局和资产局宣布规定关于有几类的食料而这个规定就很清楚。	我知道去年卫生局和资产局宣布规定关于有机类的食料而这个规定就很清楚。
您好，卧是李。您的身体怎么样？	您好，我是李。您的身体怎么样？
因为他没有钱所以他有一个大的书跟台北像片。	因为他没有钱所以他有一个大的书跟台北相片。
我深深的体会，其实网路的正面或负面影响是由自己来控制的。	我深深地体会，其实网路的正面或负面影响是由自己来控制的。
因为他走天才到台北来，所以他不知道怎嚜去学校。	因为他昨天才到台北来，所以他不知道怎么去学校。
我祝福你们幸福快乐的过每一个日子。	我祝福你们幸福快乐地过每一个日子。
情爱的父亲。	亲爱的父亲。
因为日本的雨鞋很可爱也很漂凉。	因为日本的雨鞋很可爱也很漂亮。
有的事情不可避免怀疑但我觉得虽然那么随便怀疑对方不仅是失礼而且不讲信用，如果市清揭晓清白之后应该向对方道歉才对。	有的事情不可避免怀疑但我觉得虽然那么随便怀疑对方不仅是失礼而且不讲信用，如果事情揭晓清白之后应该向对方道歉才对。
如果可以知道教室里发生的一切的话，家长会又机会早一点发现欺负，然后根据家长看到的事情，他们可以跟小孩讨论一下，免得那欺负更严重。	如果可以知道教室里发生的一切的话，家长会有机会早一点发现欺负，然后根据家长看到的事情，他们可以跟小孩讨论一下，免得那欺负更严重。
我们觉得您的公司也我们都不要这个事情让太大，所以我们希望您的公司早一点跟我们讨论这个事情。	我们觉得您的公司也我们都不要这个事情闹太大，所以我们希望您的公司早一点跟我们讨论这个事情。
随著科学技术地发展，电脑是一个普及性很高。	随著科学技术的发展，电脑是一个普及性很高。
当然狗是不少人养宠物的道选之一，因为狗既可爱又热情，而且对主人忠心耿耿。	当然狗是不少人养宠物的首选之一，因为狗既可爱又热情，而且对主人忠心耿耿。
如果您都不回应我们的反应，我们就会把您告警擦，或者邻长。	如果您都不回应我们的反应，我们就会把您告警察，或者邻长。
怎么多不方便，我觉得不该装影机比较好。	这么多不方便，我觉得不该装影机比较好。
他进去教室以后座在椅子。	他进去教室以后坐在椅子。
因为我们都觉得贰，所以吃瓜堡觉得很好吃。	因为我们都觉得饿，所以吃瓜堡觉得很好吃。
坐路差不多十分钟，我们到了。	走路差不多十分钟，我们到了。
可是因为有了电脑，科技发达，因此我们到哪里能够简单的视讯，看到远处的朋友们。	可是因为有了电脑，科技发达，因此我们到哪里能够简单地视讯，看到远处的朋友们。
应为我更了解他，我们的馆子还是不错的。	因为我更了解他，我们的馆子还是不错的。
父母一定有小孩现在做甚么的心情，父母对小孩一直在呼。	父母一定有小孩现在做甚么的心情，父母对小孩一直在乎。
他交他的朋友怎么他在美国来烤软糖的方式。	他教他的朋友怎么他在美国来烤软糖的方式。
所产生这个情形的原因大概可分三方面来看，一是国内经济的要求，一是个个家庭的情况，一是学生自己的选择。	所产生这个情形的原因大概可分三方面来看，一是国内经济的要求，一是各个家庭的情况，一是学生自己的选择。
有一个美国学生，叫做大卫。冈来台湾三天而已。	有一个美国学生，叫做大卫。刚来台湾三天而已。
我来台弯才一个多月。	我来台湾才一个多月。
那天晚上我家瞒著人和商品「ｍａｄｅｉｎＪａｐａｎ」。	那天晚上我家满著人和商品「ｍａｄｅｉｎＪａｐａｎ」。
他们是在网路上认识了现在的男伙是女朋友，现在他们已经结婚了。	他们是在网路上认识了现在的男或是女朋友，现在他们已经结婚了。
他对他的朋友说，你不要等我，如果你等我的话，你也就完点来教室。	他对他的朋友说，你不要等我，如果你等我的话，你也就晚点来教室。
然后他回来客厅，因为比塞快到开始了。	然后他回来客厅，因为比赛快到开始了。
把你很喜欢做的事情当作工作时，早上就很容易醒来，并且你能工作到晚因为快乐的时候时间就过的很快。	把你很喜欢做的事情当作工作时，早上就很容易醒来，并且你能工作到晚因为快乐的时候时间就过得很快。
我很喜欢买东西、吃饭、念书、银董、听ＭＰ３。	我很喜欢买东西、吃饭、念书、运动、听ＭＰ３。
加州有很多市场卖很新鲜水果，而截卖很好的，二手的东西真便宜。	加州有很多市场卖很新鲜水果，而且卖很好的，二手的东西真便宜。
我家在台北站北口的右遍，百货公司的对面。	我家在台北站北口的右边，百货公司的对面。
我们先跟你致函就是希望可以和解这件事情，我们乐意地要邀请你跟我们作出质询，双方都可以一起找出双赢的答案。	我们先跟你致函就是希望可以和解这件事情，我们乐意地要邀请你跟我们做出质询，双方都可以一起找出双赢的答案。
但是我不能去参加，因为我有一点事情阿！	但是我不能去参加，因为我有一点事情啊！
由于上述系区民所抱怨项目，我们在此敬请您方进行环境改善。	由于上述系居民所抱怨项目，我们在此敬请您方进行环境改善。
别的年轻人，不是他们是非常坏还是喜欢浪非他们的时间，就是他们不知道，要做什么。	别的年轻人，不是他们是非常坏还是喜欢浪费他们的时间，就是他们不知道，要做什么。
差不多３０份钟他们到了。	差不多３０分钟他们到了。
我跟她说我已经米了三个小时路新教到一条路。	我跟她说我已经迷了三个小时路新找到一条路。
爸爸，庆原谅我。不过我想说，不也是您从小就教我要拥有自己的想法与自己的目标？	爸爸，请原谅我。不过我想说，不也是您从小就教我要拥有自己的想法与自己的目标？
在加拿大的夏天太阳很晚才下，所以我们去了公园一起建走。	在加拿大的夏天太阳很晚才下，所以我们去了公园一起健走。
他们教育孩子的时候，也会一起被家长监视自己的一举一动，在这种环境哩，老师怎么能发出自己的教育力量呢？	他们教育孩子的时候，也会一起被家长监视自己的一举一动，在这种环境里，老师怎么能发出自己的教育力量呢？
我本来想要跟你一起去，可是最近我想得起来我应该做一件很重要事，所以对不起我已定不能跟你一起去。	我本来想要跟你一起去，可是最近我想得起来我应该做一件很重要事，所以对不起我一定不能跟你一起去。
晚间会听到嗓音，白天的时候大家都不会太在意，但是在睡觉的时候这嗓音成为大家的恶梦。	晚间会听到噪音，白天的时候大家都不会太在意，但是在睡觉的时候这噪音成为大家的恶梦。
看完那段文张，我是反对的！	看完那段文章，我是反对的！
我每个周末去不一样的成市。	我每个周末去不一样的城市。
美一个晚上他出去两点以前再佪家。	每一个晚上他出去两点以前再回家。
比方说：老师教学生的时候要用什么办法其实是老师的人权，那选是他们的最基本的人权。	比方说：老师教学生的时候要用什么办法其实是老师的人权，那些是他们的最基本的人权。
请你替我买一个手表。我要新的手表，因为昨天晚上我跟一个好朋友一起去吃饭的时候，我丢了。	请你替我买一个手表。我要新的手表，因为昨天晚上我跟一个好朋友一起去吃饭的时候，我丢了。
我觉得如果我们参加这个校外教学应该会认识新的台湾朋友，也会练习我们的中文，你跟我一起去把！	我觉得如果我们参加这个校外教学应该会认识新的台湾朋友，也会练习我们的中文，你跟我一起去吧！
现在我们有很多杨色，要是你要到我们公所来，所以你都可以看看。	现在我们有很多颜色，要是你要到我们公司来，所以你都可以看看。
更换或进一步改善处里味道的设备。	更换或进一步改善处理味道的设备。
对不起，我这个里拜有很多事，忙得不得了，还没有时间去看你。	对不起，我这个礼拜有很多事，忙得不得了，还没有时间去看你。
那我问您一下，我们怎么到了那么糟糕的地步呢？难道我们将来跟住＂ｆｕｋｕｓｈｉｍａ＂附近的人一样不能出去吗？也不敢因为受到污染吃任何植物吗？	那我问您一下，我们怎么到了那么糟糕的地步呢？难道我们将来跟住＂ｆｕｋｕｓｈｉｍａ＂附近的人一样不能出去吗？也不敢因为受到污染吃任何食物吗？
我觉得我们可以出去路行台湾的南部跟台中，个个人都觉得很美，我要请你去陆行。	我觉得我们可以出去旅行台湾的南部跟台中，个个人都觉得很美，我要请你去旅行。
我们要一起看旁棒球的比赛，跟朋友一起看比一个人看好很多。	我们要一起看盘棒球的比赛，跟朋友一起看比一个人看好很多。
我会支持妳呀，加油喔！我也偷偷的跟大年沟通一下吧。	我会支持妳呀，加油喔！我也偷偷地跟大年沟通一下吧。
我下个星期非常忙所以我不能参家你的舞会。	我下个星期非常忙所以我不能参加你的舞会。
休息时间只是从中午１２点半到一点，在加上９点才下班。	休息时间只是从中午１２点半到一点，再加上９点才下班。
如果老师不能表达自己的个性来工作，学生就会收到不好的影响让他们不会表达自己真的个性。	如果老师不能表达自己的个性来工作，学生就会受到不好的影响让他们不会表达自己真的个性。
我知道您想把您一生多么辛苦建设的公司交给我这样您可以安心的退休了，您希望我接受您的安排去做。	我知道您想把您一生多么辛苦建设的公司交给我这样您可以安心地退休了，您希望我接受您的安排去做。
还是你们也可以般出去离我们这边，这样我们也不想太多东西麻烦你们。	还是你们也可以搬出去离我们这边，这样我们也不想太多东西麻烦你们。
还有随便丢掉的怀人抓他。被他罚很多钱才对的。	还有随便丢掉的坏人抓他。被他罚很多钱才对的。
在这样的情况下，孩子们也会开开兴兴学习、玩儿、交朋友、等。	在这样的情况下，孩子们也会开开心心学习、玩儿、交朋友、等。
我觉得校长的作法很棒，教室里应该装影机。	我觉得校长的做法很棒，教室里应该装影机。
所以应该让孩子们多接触各种不同的方面，这样他们会发现自己所喜欢的，也能够自发地去学习。	所以应该让孩子们多接触各种不同的方面，这样他们会发现自己所喜欢的，也能够自发地去学习。
他们一扁吃，一扁聊天。	他们一边吃，一边聊天。
政治大学的对面有一家很有名的餐厅，他们的采盘盘都好吃，我们去那边吧！	政治大学的对面有一家很有名的餐厅，他们的菜盘盘都好吃，我们去那边吧！
除了老人家不能休息因为环境不安竟以外连吃东西也吃不下，由于到处是臭臭的味道，谁可以吃得下呢？	除了老人家不能休息因为环境不安静以外连吃东西也吃不下，由于到处是臭臭的味道，谁可以吃得下呢？
他刚快去公车停车站等下次的公车。	他赶快去公车停车站等下次的公车。
一般所有的公司都愿意雇用男生。因为他们认为男生的体力比女生更大就很快把工作干完。	一般所有的公司都愿意雇用男生。因为他们认为男生的体力比女生更大就很快把工作干完。
他越觉得你很有趣很好骗的人，搞不好他现在还在偷笑你。	他也觉得你很有趣很好骗的人，搞不好他现在还在偷笑你。
因为像人，牠比较小的时候不会记得出了什么事，所以不会受到心理上的通苦。	因为像人，牠比较小的时候不会记得出了什么事，所以不会受到心理上的痛苦。
因为小安没人琣他，他有一点不高兴。	因为小安没人陪他，他有一点不高兴。
你的同学也是太过分了，他一定在跟你开玩笑假装没有跟你定书，也许他不知道今天你要带书来给他所以没有准备钱来。	你的同学也是太过分了，他一定在跟你开玩笑假装没有跟你订书，也许他不知道今天你要带书来给他所以没有准备钱来。
应为对我第一次去高雄所以我很高兴，可是不能去真可惜。	因为对我第一次去高雄所以我很高兴，可是不能去真可惜。
去打工不是为了帮助父母交学费，而是为了有更多的钱可以花在娱乐活动，如周末去酒吧、卡拉ＯＫ、电影院等等。	去打工不是为了帮助父母交学费，而是为了有更多的钱可以花在娱乐活动，如周末去酒吧、卡拉ＯＫ、电影院等等。
但是因为生态和环保的关系，这两个曾加美国发展的机会都失败了。	但是因为生态和环保的关系，这两个增加美国发展的机会都失败了。
我们以起吃饭和慢慢变成好朋友。	我们一起吃饭和慢慢变成好朋友。
我感冒得连饭都吃部下，而且我走不了多久，头就晕了。	我感冒得连饭都吃不下，而且我走不了多久，头就晕了。
我真的洗碗我可以去看你。	我真的希望我可以去看你。
第三个问题：安全性的问题。可能坏人录音教室里的情况会用不好的事情。	第三个问题：安全性的问题。可能坏人录影教室里的情况会用不好的事情。
听起来是一份很好的公司。又意思又很多钱。	听起来是一份很好的公司。有意思又很多钱。
虽然我明白他是不得不那样，应为百天我跟购一直在一起，可是他不因该那样怀疑我。	虽然我明白他是不得不那样，因为白天我跟狗一直在一起，可是他不应该那样怀疑我。
我知道你工作了很久，块想要休息，跟妈妈一起享受休闲的生活。	我知道你工作了很久，快想要休息，跟妈妈一起享受休闲的生活。
上个礼拜阿，我的公司也实行了「大量裁员」之计划。	上个礼拜啊，我的公司也实行了「大量裁员」之计划。
家长们一大早就出门，晚间回来是孩子都入梦。	家长们一大早就出门，晚间回来时孩子都入梦。
在台湾的青少年不分夜晚或白日的一直使用电脑，而我在德国的朋友也是如此，也因为这样，我们才能在有时差的状况下保持热线。	在台湾的青少年不分夜晚或白日地一直使用电脑，而我在德国的朋友也是如此，也因为这样，我们才能在有时差的状况下保持热线。
上个月我自即去乡下的地方走路。	上个月我自己去乡下的地方走路。
对青少年来说，好不易区别他们是不是可以相心的人。	对青少年来说，好不易区别他们是不是可以相信的人。
因为我下个礼拜有很重要的考试，所以得要好好地复习。	因为我下个礼拜有很重要的考试，所以得要好好地复习。
我希冠你快要好了。	我希望你快要好了。
大家都发挥公德心，为了我们的还竟，我们的未来。	大家都发挥公德心，为了我们的环境，我们的未来。
但是也在半工半读的路上，千万千万别忘了，最求自己最纯真的梦想。	但是也在半工半读的路上，千万千万别忘了，追求自己最纯真的梦想。
老实说「大维必须在教室前面站」，大卫觉得好秀。	老实说「大卫必须在教室前面站」，大卫觉得好羞。
他问一个小姐棒他。	他问一个小姐帮他。
从古亭站往师大一直走，走到７－１１给我打电话我借你们！	从古亭站往师大一直走，走到７－１１给我打电话我接你们！
我是王天华，跟你想要去流行。	我是王天华，跟你想要去旅行。
我想网站也??一个东西很好的，什么不董的话都可以上网看就知道啊，所以网路队我来讲是很好的，可是队小孩子的有一点不好。	我想网站也??一个东西很好的，什么不懂的话都可以上网看就知道啊，所以网路对我来讲是很好的，可是对小孩子的有一点不好。
我真的担心你，也想看你可是现在我不在台杯所以真的不能看你，真的对你不好意思。	我真的担心你，也想看你可是现在我不在台北所以真的不能看你，真的对你不好意思。
做生意并不简单，天天要找办法来得利益，导致心理上巨大的压力。我从来知道我没办法适合这种生崖。	做生意并不简单，天天要找办法来得利益，导致心理上巨大的压力。我从来知道我没办法适合这种生涯。
我还不知道如果这件事是每一个里拜四跟明天一样，可是我知道的时候马上告诉您。	我还不知道如果这件事是每一个礼拜四跟明天一样，可是我知道的时候马上告诉您。
到了桃园火车站因为人多而改座两辆计程车。	到了桃园火车站因为人多而改坐两辆计程车。
我喜欢你贵公司的工人工走得非常认真，每天六点开始工作，但是对我们邻居来说，这样的事情给我们很大的麻烦。	我喜欢你贵公司的工人工作得非常认真，每天六点开始工作，但是对我们邻居来说，这样的事情给我们很大的麻烦。
下个星期是我的生日共喜。	下个星期是我的生日恭喜。
如果孩子白天没有精神或上课的时候睡著，他们可能生病或不过睡觉。	如果孩子白天没有精神或上课的时候睡著，他们可能生病或不够睡觉。
要是我走的那么满，一定不能坐。怎么办？	要是我走的那么慢，一定不能坐。怎么办？
就算小学常是保护孩子们的隐私，未来有很大的可能性影片会被偷或被坏人用在不好的方面。	就算小学尝试保护孩子们的隐私，未来有很大的可能性影片会被偷或被坏人用在不好的方面。
我们邻居一直在自问到底这个臭味是从哪里来的，后来才发现好像工厂的废物直接仍在我们这些大楼后面的河里！	我们邻居一直在自问到底这个臭味是从哪里来的，后来才发现好像工厂的废物直接扔在我们这些大楼后面的河里！
所有的学生都非常认真也很安静，王天华是第一次交弮的人。	所有的学生都非常认真也很安静，王天华是第一次交卷的人。
还有在那个包包里面里可以放很多礼物待你的国家，所以你可以那些礼物给你的家人让他们高心。	还有在那个包包里面里可以放很多礼物到你的国家，所以你可以那些礼物给你的家人让他们高兴。
我很高兴受到你的信，同时也替你担心。	我很高兴收到你的信，同时也替你担心。
目前我们的身体不太好，有的人看医生往院了，有的人搬家了。原因是甚么？可以改善吗？	目前我们的身体不太好，有的人看医生住院了，有的人搬家了。原因是甚么？可以改善吗？
对我自己来说，我觉得现在是往新时代的过度期。	对我自己来说，我觉得现在是往新时代的过渡期。
所以录影机除了必老师离开也可以把他的教法的秘诀公开	所以录影机除了逼老师离开也可以把他的教法的秘诀公开
小王今天跟夏美有约会。他很警张，所以他今天六点半就起床了。	小王今天跟夏美有约会。他很紧张，所以他今天六点半就起床了。
面对今天妳被怀疑偷钱包的事情，却实我觉得妳应该发点菩萨心，把自己跟被偷东西的人换位子想。心	面对今天妳被怀疑偷钱包的事情，确实我觉得妳应该发点菩萨心，把自己跟被偷东西的人换位子想。心
我是王天华，我代表我们邻居人住在你们工厂付近。	我是王天华，我代表我们邻居人住在你们工厂附近。
他虽然年几比我小，可是他去国外学道英文，学道经济。	他虽然年纪比我小，可是他去国外学到英文，学到经济。
后来，我也还想有恶心的感觉。	后来，我也好像有恶心的感觉。
因为我想死她了，所以梅天晚上我睡觉之前，我想起来她上次来看我。	因为我想死她了，所以每天晚上我睡觉之前，我想起来她上次来看我。
所为爱的教学是不体罚而用劝说的方式来教育学生。	所谓爱的教学是不体罚而用劝说的方式来教育学生。
你们的工厂是三十年以前开的，我觉得你们也可以去问政府可以不可以给你们钱为了编号你们的工厂。	你们的工厂是三十年以前开的，我觉得你们也可以去问政府可以不可以给你们钱为了变好你们的工厂。
别的原因、我不喜欢要很多费用。我觉得对这样不用负钱。	别的原因、我不喜欢要很多费用。我觉得对这样不用付钱。
我八点差五分到班公司来找您，可是找不著您，所以我决定留一张字条。	我八点差五分到办公室来找您，可是找不著您，所以我决定留一张字条。
如过要充分利用网路的好处，那就要找到平衡点。	如果要充分利用网路的好处，那就要找到平衡点。
他又高又受，有红颜色的头发，蓝颜色的眼睛。	他又高又瘦，有红颜色的头发，蓝颜色的眼睛。
我知道公司是你的心血，在加上你只有我们两个兄弟，所以公司的未来不靠我们，那靠谁呢？	我知道公司是你的心血，再加上你只有我们两个兄弟，所以公司的未来不靠我们，那靠谁呢？
我们然后去新家波看他的城市那么发展。	我们然后去新加坡看他的城市那么发展。
一定要逼您们还给老性正常的生活。而且，还给您们罚钱。	一定要逼您们还给老姓正常的生活。而且，还给您们罚钱。
一般大一、大二学生都坐家师或发广告片，大三、大四学生可以在某些公司坐半天工作。	一般大一、大二学生都做家事或发广告片，大三、大四学生可以在某些公司做半天工作。
不要因为那位同学觉得你是小偷而导致你对他有偏见，我相信他心理一定比妳更尴尬更不舒服。	不要因为那位同学觉得你是小偷而导致你对他有偏见，我相信他心里一定比妳更尴尬更不舒服。
可是以前的环境的话女人结婚生孩子之后没办法继续工作。因为社会没有结婚生孩子之后女人可以继续公做的安排。	可是以前的环境的话女人结婚生孩子之后没办法继续工作。因为社会没有结婚生孩子之后女人可以继续工作的安排。
如果孩子念未来赚不到很多钱的系像音乐、文法、艺术等，那么不多浪费。	如果孩子念未来赚不到很多钱的系像音乐、文法、艺术等，那么不多浪费。
而有些小朋友很调皮，常常乱闹、抓弄别人，老师讲一两次可能也听不进去。	而有些小朋友很调皮，常常乱闹、捉弄别人，老师讲一两次可能也听不进去。
首先我要说辛苦您们天天的徒劳，同时希望你们会拿到更好的利益与信赖。	首先我要说辛苦您们天天的苦劳，同时希望你们会拿到更好的利益与信赖。
好了，美关系了。我们坐下来吃饭吧！	好了，没关系了。我们坐下来吃饭吧！
不过适当的使用网路比起整天在电脑前面茶不思饭不想的行为可以发挥更好的帮助。	不过适当地使用网路比起整天在电脑前面茶不思饭不想的行为可以发挥更好的帮助。
其实我也有一个这种经验，从现在简单的介绍那一个事情吧。	其实我也有一个这种经验，从现在简单地介绍那一个事情吧。
希望后天我会上可了。	希望后天我会上课了。
这里的公车是，应该５个小时一班阿！	这里的公车是，应该５个小时一班啊！
上课的时候有一个学生不懂再黑板写的东西，他的同学把这些东西教他。	上课的时候有一个学生不懂在黑板写的东西，他的同学把这些东西教他。
我不咀导要是买聘果西瓜李子。	我不知道要是买苹果西瓜李子。
我发山发的很好。	我爬山爬的很好。
考完试以后我就有空了，所以等考完是我再给你打电话，好吗？	考完试以后我就有空了，所以等考完试我再给你打电话，好吗？
大家受不了了，所以我要介意您们这么样可以处理？！	大家受不了了，所以我要建议您们怎么样可以处理？！
下午二点二十分，我们上课，下午学很多字合唱父系语法，所以我们常觉得有一点累。	下午二点二十分，我们上课，下午学很多字和常复习语法，所以我们常觉得有一点累。
在山上有很多木都是录色的，空气也很好。	在山上有很多木都是绿色的，空气也很好。
作天我的叫李大明的好朋友到我家来。	昨天我的叫李大明的好朋友到我家来。
因此，我才了解我所学到的经济方面知识有助帮别人的忙，使它们进一步发展。	因此，我才了解我所学到的经济方面知识有助帮别人的忙，使他们进一步发展。
因为现在的社会上如果你不断的学习不断的接受新的知识你有可能被社会淘汰，现代女性工作能力很强，他们可以去外面工作同时也能把家里的事情安排得很好。	因为现在的社会上如果你不断地学习不断的接受新的知识你有可能被社会淘汰，现代女性工作能力很强，她们可以去外面工作同时也能把家里的事情安排得很好。
所以他请一个小姐帮告诉他从这里到市大学校怎么走？然后再那个小姐告诉他市大学校从这里往前面一直走经过十字路口就到市大学校了。	所以他请一个小姐帮告诉他从这里到师大学校怎么走？然后再那个小姐告诉他师大学校从这里往前面一直走经过十字路口就到师大学校了。
你也可以给自己放假，现在好好休息，等到经济恢复时，你就可以好好的干一番事业了。	你也可以给自己放假，现在好好休息，等到经济恢复时，你就可以好好的干一番事业了。
我只有最小一个月旅行，你能去多久？	我只有最少一个月旅行，你能去多久？
来了台湾的时候他一个中国句子都不会说、一个图片都看不懂、还有一个朋友都没有，怎门办？	来了台湾的时候他一个中国句子都不会说、一个图片都看不懂、还有一个朋友都没有，怎么办？
如果叫大学生不应该半工半读，我们社会可以负得起这些学生的生活负担吗？负得起他的学费吗？	如果叫大学生不应该半工半读，我们社会可以付得起这些学生的生活负担吗？负得起他的学费吗？
我们可以去四班牙，因为我的父母住在哪里，还有很多地方我们可以去玩。	我们可以去西班牙，因为我的父母住在那里，还有很多地方我们可以去玩。
他们可能觉得这才是学生的生活，这样才算起来你是张大了。	他们可能觉得这才是学生的生活，这样才算起来你是长大了。
珍现在赶快休息休息，补充体力准备迎见新的开始吧。	趁现在赶快休息休息，补充体力准备迎接新的开始吧。
但对未来我有一些打算，不依定像您经营的事业的发展但我还希望可以实现。	但对未来我有一些打算，不一定像您经营的事业的发展但我还希望可以实现。
如果是因为刺激经济及交通方便而失去即有的自然。独特动植物，的确是太大的损失了。	如果是因为刺激经济及交通方便而失去既有的自然。独特动植物，的确是太大的损失了。
那天我定了我们以前很喜欢一起去的馆子，就一起好好叙叙旧吧！	那天我订了我们以前很喜欢一起去的馆子，就一起好好叙叙旧吧！
你的家人的生体好？	你的家人的身体好？
你是我的学生阿？	你是我的学生啊？
因为时间的关系，都极少和家人相处，就趁著这个机会顺道和家人好好的去玩玩，放松一下心情，这何尝不是件好事呢。	因为时间的关系，都极少和家人相处，就趁著这个机会顺道和家人好好地去玩玩，放松一下心情，这何尝不是件好事呢。
我们可以聊以前上学时的事情，开开心心的聊。	我们可以聊以前上学时的事情，开开心心地聊。
现在回到家，慢慢再想起今天的事情，一定对妳感到抱歉，改天应该会想妳道歉。	现在回到家，慢慢再想起今天的事情，一定对妳感到抱歉，改天应该会向妳道歉。
我又跟爸爸妈妈去美国玩，美国风景好漂亮，交通很旁边。	我有跟爸爸妈妈去美国玩，美国风景好漂亮，交通很方便。
如果这样色事情一直发生的话，恐怕会影响到邻居们的身体健康与生活品质。	如果这样的事情一直发生的话，恐怕会影响到邻居们的身体健康与生活品质。
也请你注意要是你不把这下问题处理好的话我们会告到法院去，那是看看你还爱能做甚么。	也请你注意要是你不把这些问题处理好的话我们会告到法院去，那时看看你还爱能做甚么。
他们想看电影、听音乐、和朋友聊天等等都有电脑里，非常方便。	他们想看电影、听音乐、和朋友聊天等等都由电脑里，非常方便。
后天是小明的生日，我要开一个无会。	后天是小明的生日，我要开一个舞会。
李厂长，不知道您会不会觉得我太夸奖了。可是这不但是我们一个家庭的问题，大部分的邻居都说一样的问题。	李厂长，不知道您会不会觉得我太夸张了。可是这不但是我们一个家庭的问题，大部分的邻居都说一样的问题。
因为我们有听说过很多不好的事情，好像有些老师的照顾不太好，还是他们没有耐心，应为真的照顾孩子需要耐心，然后听说过有一些老实会打孩子，所以这样的想法会让母亲不会那么担心	因为我们有听说过很多不好的事情，好像有些老师的照顾不太好，还是他们没有耐心，因为真的照顾孩子需要耐心，然后听说过有一些老师会打孩子，所以这样的想法会让母亲不会那么担心
不过得准备的东西不但吃的，而且对休闲活动来说有了好好地经验！	不过得准备的东西不但吃的，而且对休闲活动来说有了好好的经验！
下个星期休假，所以我想跟你去路行。	下个星期休假，所以我想跟你去旅行。
长爱文也高兴得很：「恭喜，恭喜！我也想去，可是我准备考试，最近有点茫，我打算者写一些工课，所以我明天不知道能不能参加。	张爱文也高兴得很：「恭喜，恭喜！我也想去，可是我准备考试，最近有点忙，我打算著写一些功课，所以我明天不知道能不能参加。
她提以他们五点晚上去电影院看一个新电影．	她提议他们五点晚上去电影院看一个新电影．
是因为他认为：「我是名校出来的人！」，眼光太高，要选的工作一定比别人好，薪水又要高才对得起自起的能力。	是因为他认为：「我是名校出来的人！」，眼光太高，要选的工作一定比别人好，薪水又要高才对得起自己的能力。
对孩子们来说，他们也年不料数因为不能专心地念。	对孩子们来说，他们也念不了书因为不能专心地念。
大明阿你知道吗？之前我的公司也受到经济的影响所以都没有工作也放无薪假，我每天都烦恼，怎么让公司的生意会好起来呢！	大明啊你知道吗？之前我的公司也受到经济的影响所以都没有工作也放无薪假，我每天都烦恼，怎么让公司的生意会好起来呢！
为此我感到非常的困惑，如果连这个最基本的生活条件都不能保证我们普通老百姓怎么能平平安安地过日子。	为此我感到非常地困惑，如果连这个最基本的生活条件都不能保证我们普通老百姓怎么能平平安安地过日子。
差不多四点半我来过，可使你不在这。	差不多四点半我来过，可是你不在这。
过了三十分钟后，下著雨了！	过了三十分钟后，下著雨了！
每天要他替我带班１５分到半个小时只要为了丢垃圾、洗厕所！	每天要他替我代班１５分到半个小时只要为了丢垃圾、洗厕所！
今天我要告诉您下个月我要会我的国家，因为我很想我的父母，所以我要问您要不要跟我去我国家。	今天我要告诉您下个月我要回我的国家，因为我很想我的父母，所以我要问您要不要跟我去我国家。
我最近常常在电视上看到教育现场发生的问题，例如有的学生暴凌、老师打学生等等。	我最近常常在电视上看到教育现场发生的问题，例如有的学生霸凌、老师打学生等等。
假设有老师在教室里大学生的话或是相反的学生打老师的事件，这个监视器的画面也可以当一个证据。	假设有老师在教室里打学生的话或是相反的学生打老师的事件，这个监视器的画面也可以当一个证据。
比方说，为了去打工而身体很累因此跷课、如果能取得学份不懂上课内容也没关系，还是会存在拥有这种想法的学生。	比方说，为了去打工而身体很累因此跷课、如果能取得学分不懂上课内容也没关系，还是会存在拥有这种想法的学生。
凯钧那天对我很好，请我座在沙发上，然后就去了厨房帮我们从冰箱里拿饮料和饼干。	凯钧那天对我很好，请我坐在沙发上，然后就去了厨房帮我们从冰箱里拿饮料和饼干。
在公车站很多人在等公车，因为是上班的事件。	在公车站很多人在等公车，因为是上班的时间。
老公，老婆由父母帮你安排选择。如果嫁错人，女孩子只能函泪接受。	老公，老婆由父母帮你安排选择。如果嫁错人，女孩子只能含泪接受。
要失有空时后我们都吃饭吗？	要是有空时候我们都吃饭吗？
只有一个是让他不愿意是台北人用那么摩模托车，所以看起来空气有一点让。	只有一个是让他不愿意是台北人用那么摩模托车，所以看起来空气有一点脏。
所以如果发生了什么事就可以用监视器来看或者可以直接打电话给学校教学校改善。	所以如果发生了什么事就可以用监视器来看或者可以直接打电话给学校叫学校改善。
一方面可以不断的训练自己的人生知识，也可以证明自己，提高女人在社会的地位。	一方面可以不断地训练自己的人生知识，也可以证明自己，提高女人在社会的地位。
大明不知道怎么办因为明天又以个很重要的大考。	大明不知道怎么办因为明天有一个很重要的大考。
你知道你比起那些没有工作的人还是很幸运，那你要更好好的工作，知道吗？	你知道你比起那些没有工作的人还是很幸运，那你要更好好地工作，知道吗？
我想，妳只所以会写信给我这个遥远的朋友，必然是因为身边没有可以倾诉的对象。	我想，妳之所以会写信给我这个遥远的朋友，必然是因为身边没有可以倾诉的对象。
我起床的时候，吃早饭。	我起床的时候，吃早饭。
若在两周之内，其「噪音」及「臭味」亦然存在。我们不得不藉法律的方法并提出讼诉解决。	若在两周之内，其「噪音」及「臭味」依然存在。我们不得不藉法律的方法并提出讼诉解决。
因为我的同是用台语跟国语混在一起说，我听不懂。	因为我的同事用台语跟国语混在一起说，我听不懂。
在韩国私立大学的一个学期学费超过新台币十万元，有些学生为减轻父母负担休学一年或一个学习去打工赚钱。	在韩国私立大学的一个学期学费超过新台币十万元，有些学生为减轻父母负担休学一年或一个学期去打工赚钱。
希望你放送心情地尽量去玩，你回来的时候可以跟我们全班同学一起分享你去游玩的过程中！	希望你放松心情地尽量去玩，你回来的时候可以跟我们全班同学一起分享你去游玩的过程中！
我的家里学校很近，所以我常走路去学校学习，走路大概十分钟就到了。	我的家离学校很近，所以我常走路去学校学习，走路大概十分钟就到了。
他座捷运到学校的附近站，但是下了车以后他迷路了。	他坐捷运到学校的附近站，但是下了车以后他迷路了。
随著电器的发达，家庭主妇该做的家事也相对的省力了。	随著电器的发达，家庭主妇该做的家事也相对地省力了。
而且把车子都在放者，上下班的时候座公车。	而且把车子都在放著，上下班的时候坐公车。
有的应该家芝麻酱，有的要赛在面包里才对。	有的应该加芝麻酱，有的要塞在面包里才对。
我是您的工厂附近住的王天华，今天我作为邻居代表写一封信给您。	我是您的工厂附近住的王天华，今天我做为邻居代表写一封信给您。
如果有机会你就问问他，会不会他自己忘了放那里，如果他还是说不见的话，那我看你以后也要小心一点。	如果有机会你就问问他，会不会他自己忘了放哪里，如果他还是说不见的话，那我看你以后也要小心一点。
他们做二九七的公车去。	他们坐二九七的公车去。
关于在教室内庄摄影机，我个人觉得这是一个很不错的方案。	关于在教室内装摄影机，我个人觉得这是一个很不错的方案。
这位小姐很客气就告诉他从这理到学校怎么去，很简单，只要从这理往一直走，经过两第路口，走路大概十五分钟就到了。	这位小姐很客气就告诉他从这里到学校怎么去，很简单，只要从这理往一直走，经过两第路口，走路大概十五分钟就到了。
你的公交孩子真实是普通的事况，但是我自己又已经有了生计划，所以现在没办法去做控制你的公司。	你的公交孩子真实是普通的事况，但是我自己又已经有人生计划，所以现在没办法去做控制你的公司。
想说白天大家都上班，多少能必开这些困扰但晚上回来，原本可以好好休息、放松自己，小孩也能好好做功课，但您工厂又进行加班。	想说白天大家都上班，多少能避开这些困扰但晚上回来，原本可以好好休息、放松自己，小孩也能好好做功课，但您工厂又进行加班。
在加上除了拿到博士学位的人以外，就业的时候没有受到限制。	再加上除了拿到博士学位的人以外，就业的时候没有受到限制。
第二原因我反对这个想法就是家长没那么多时间来注意或著看小孩。	第二原因我反对这个想法就是家长没那么多时间来注意或者看小孩。
自从二十年代开始，越来越多人因为工作会从他们的加班到新的地方去。	自从二十年代开始，越来越多人因为工作会从他们的家搬到新的地方去。
工厂的臭味可恶要命了，我们以为你的工厂抢造纸，可是工厂的臭味好象茅抗。	工厂的臭味可恶要命了，我们以为你的工厂抢造纸，可是工厂的臭味好像茅坑。
如果你跟朋友要去晚，你要早一点回家。	如果你跟朋友要去玩，你要早一点回家。
中国大陆崛起背后有严重的环境污染，为了得到经济效益，滥伐亚迈逊热带雨林，导致地球暖化现象更加严重。	中国大陆崛起背后有严重的环境污染，为了得到经济效益，滥伐亚马逊热带雨林，导致地球暖化现象更加严重。
五十年前在美国有很多人吸烟，这些人得艾症的可能性很高，而且很多是穷人。	五十年前在美国有很多人吸烟，这些人得癌症的可能性很高，而且很多是穷人。
明天，我不能来上果，因为明天，我父母来台北。	明天，我不能来上课，因为明天，我父母来台北。
如果您这一个月以内没处理的话，我们跟电视公司要说您怎么害我们的生活，而跟裁判师要告诉跟法律上需要解决。	如果您这一个月以内没处理的话，我们跟电视公司要说您怎么害我们的生活，和跟裁判师要告诉跟法律上需要解决。
对我来说青少年用上网得事情是一个很不好的情况，我曾经看他们都是上网玩游戏及找朋友。	对我来说青少年用上网的事情是一个很不好的情况，我曾经看他们都是上网玩游戏及找朋友。
李大年的事的确是一个问提，看起来你有点吃亏了。	李大年的事的确是一个问题，看起来你有点吃亏了。
老师就给他两张电影票，要他请一个朋友谊起去看。	老师就给他两张电影票，要他请一个朋友一起去看。
事情在国小是我孩子的秘密。如果他要告诉我，他应该要。可是如果他不想要、他不用告诉我。我不可以看看以下。	事情在国小是我孩子的秘密。如果他要告诉我，他应该要。可是如果他不想要、他不用告诉我。我不可以看看一下。
二十四小时之内上班，带孩子，整理家，煮饭，么装的下？	二十四小时之内上班，带孩子，整理家，煮饭，么装得下？
他们开始学中文，一定最前的子＂你好＂。	他们开始学中文，一定最前的字＂你好＂。
虽然我们各个住在的地方那么远，我们披此也继续连络对我来说这个让我很安慰。	虽然我们各个住在的地方那么远，我们彼此也继续连络对我来说这个让我很安慰。
欸，世界上一半是女孩子也，不要这样那么伤心。	欸，世界上一半是女孩子耶，不要这样那么伤心。
之前我也有经历过「无薪假」，那时我的孩子也还很小，每天都过的节省。	之前我也有经历过「无薪假」，那时我的孩子也还很小，每天都过得节省。
有一个开红色车的男人，他看见我在路边交马上停车。	有一个开红色车的男人，他看见我在路边叫马上停车。
我听了就放心了，所以我跟他们全晚一起跳无。	我听了就放心了，所以我跟他们全晚一起跳舞。
大明不喜欢等一等，他觉得邓的时候让他很紧张也觉得很麻烦。	大明不喜欢等一等，他觉得等的时候让他很紧张也觉得很麻烦。
「觉之教育」以觉智办校，就是说不但只要觉而且觉后要用出世间的智慧处理入世间的事，科技必须有道，要不然，我们几千年优秀的文化会毁于一代。	「觉之教育」以觉智办校，就是说不单只要觉而且觉后要用出世间的智慧处理入世间的事，科技必须有道，要不然，我们几千年优秀的文化会毁于一旦。
好久不见，您最近如何？我还是像以前依样很忙碌。	好久不见，您最近如何？我还是像以前一样很忙碌。
如果父母觉得需要道地管理孩子，孩子变成父母的财产。	如果父母觉得需要到底管理孩子，孩子变成父母的财产。
虽然人与人之问关系很复杂，让我们花了不少的精神、时间可是值得克服。	虽然人与人之间关系很复杂，让我们花了不少的精神、时间可是值得克服。
这个都是对我们的未来会给很大的影响，而且第一次进入的公司是很重要的，所以现在韩国年轻人大部分都考卢过毕业后立刻找工作或继续上研究所。	这个都是对我们的未来会给很大的影响，而且第一次进入的公司是很重要的，所以现在韩国年轻人大部分都考虑过毕业后立刻找工作或继续上研究所。
每天都在家里，我一直想我那么大了还是再吃爸爸妈妈的饭，心里觉得害羞得不得了。	每天都在家里，我一直想我那么大了还是在吃爸爸妈妈的饭，心里觉得害羞得不得了。
对不气，最近我很忙，所以我不会去妳的。	对不起，最近我很忙，所以我不会去妳的。
媒体上整天在提出这种观点，批评主妇的该念快是一种时髦，而很少会听到好处根乐趣。	媒体上整天在提出这种观点，批评主妇的概念快是一种时髦，而很少会听到好处跟乐趣。
我的一个朋友高三的时候，压力太大常常吃要忍耐三年，后来考上首尔大学，这不是结束，当大要薪水高的工作，一定要毕业好的学校，这是合理的。	我的一个朋友高三的时候，压力太大常常吃要忍耐三年，后来考上首尔大学，这不是结束，当他要薪水高的工作，一定要毕业好的学校，这是合理的。
所人不因该太依赖一个东西，毕竟他只是一个机器而已。	所人不应该太依赖一个东西，毕竟他只是一个机器而已。
万一您不想改善目前的情况的话，我们会向法院告贵工厂，也要跟媒体说我们住民的困捞。	万一您不想改善目前的情况的话，我们会向法院告贵工厂，也要跟媒体说我们住民的困扰。
正因为如此，所以我赞成家长现制青少年上网时数。	正因为如此，所以我赞成家长限制青少年上网时数。
你找一个时间再跟他好好谈一谈吧！找一个两个人心情比较愉快的时后再好好商量。	你找一个时间再跟他好好谈一谈吧！找一个两个人心情比较愉快的时候再好好商量。
我的看法是，留学生刚到一个新的环境的时候，都是莫生人，很难以分辨谁的性格可靠，谁你不能相信。	我的看法是，留学生刚到一个新的环境的时候，都是陌生人，很难以分辨谁的性格可靠，谁你不能相信。
刚好公司排我去淡生意，所以我走不开的。	刚好公司派我去谈生意，所以我走不开的。
他门马上打包都东西，下雨更大，所以他们搬到别的地方。	他们马上打包都东西，下雨更大，所以他们搬到别的地方。
没想到李大年是哪种说话不承认的人。我从来还以为他是一个可以相信的男子汉。	没想到李大年是那种说话不承认的人。我从来还以为他是一个可以相信的男子汉。
冬季时来会比较好。因为那个时候，你可以尝试许多韩国独有的各种火锅。	冬季时来会比较好。因为那个时候，你可以尝试许多韩国独有的各种火锅。
他在家里看电视的时间，听到有人叫们，然后他去开门看到王先生来看家我们，他真的好开兴了！	他在家里看电视的时间，听到有人叫门，然后他去开门看到王先生来看家我们，他真的好开心了！
我的家离古亭站不远，我六点就跟你们那理见面，好不好？	我的家离古亭站不远，我六点就跟你们那里见面，好不好？
我们仅是世界上的一种动物而已，而且我们是很易靠社会赶来决定的一个动物。	我们仅是世界上的一种动物而已，而且我们是很易靠社会感来决定的一个动物。
他是季子，有兄的事实没有那么重要吧！交给较能干的人是对的。	他是继子，有兄的事实没有那么重要吧！交给较能干的人是对的。
主要是不用去在意这个事情，想太多就会浪费时间，好好保获时间去念书比较好。	主要是不用去在意这个事情，想太多就会浪费时间，好好把握时间去念书比较好。
所以我决定要努力的把我的专业学好，也要继续学好中文，这样就算是再一次的金融风暴也不会影响到我们。	所以我决定要努力地把我的专业学好，也要继续学好中文，这样就算是再一次的金融风暴也不会影响到我们。
宠物出租可以让我们高兴，也可以舒发压力，这样才可以享受人生的乐趣阿。	宠物出租可以让我们高兴，也可以舒发压力，这样才可以享受人生的乐趣啊。
我家有五个人，爸爸、吗吗、一个哥哥、一个妹妹和我。	我家有五个人，爸爸、妈妈、一个哥哥、一个妹妹和我。
我知道您目前出赛在国外，那我大概陈述每天工厂的邻居和我怎么说。	我知道您目前出差在国外，那我大概陈述每天工厂的邻居和我怎么说。
大明一些啤酒和一些平干拿出来在冷箱。	大明一些啤酒和一些饼干拿出来在冷箱。
有时候看著这些年轻人从面试时的意气风发，渐渐地被社会的惨忍抹灭了热情，都会让我深深地感到不忍。	有时候看著这些年轻人从面试时的意气风发，渐渐地被社会的残忍抹灭了热情，都会让我深深地感到不忍。
我的生日会因为有你和朋友们参加与支持显得格外的热闹。在这里要谢谢你们在我生日会上给了我一个前所未有的惊喜。	我的生日会因为有你和朋友们参加与支持显得格外地热闹。在这里要谢谢你们在我生日会上给了我一个前所未有的惊喜。
秋天的时候常常下大雨，括大风。	秋天的时候常常下大雨，刮大风。
据我所知噪音的原因是您工厂的设备响的，所以希望您叫传家来修理，让邻居们有个安静的生活。	据我所知噪音的原因是您工厂的设备响的，所以希望您叫专家来修理，让邻居们有个安静的生活。
你不但让我们家过得快了的日子，也教了我们无数的道德，当作我们人生的灯塔。	你不但让我们家过得快乐的日子，也教了我们无数的道德，当作我们人生的灯塔。
我听说日本的电脑很好，还有很研。	我听说日本的电脑很好，还有很颜。
除了台湾以外，全世界国家有意务保户地求。	除了台湾以外，全世界国家有义务保护地球。
改天我来看你，好不好？别忘河水跟吃药。	改天我来看你，好不好？别忘喝水跟吃药。
中国人和西方人的观念差不多，送孩子去读那们贵的学校，成本也得赚回来。	中国人和西方人的观念差不多，送孩子去读那么贵的学校，成本也得赚回来。
操音过大有时候我测量音达到８５ｄＢ。而且臭味也很重，特别是您们工厂处理化学药物的时候。	噪音过大有时候我测量音达到８５ｄＢ。而且臭味也很重，特别是您们工厂处理化学药物的时候。
我知道每个做父母的人都很关心他们的孩子，然而个游客个观念，每个人都不一样。	我知道每个做父母的人都很关心他们的孩子，然而各有各的观念，每个人都不一样。
或者是你也可奉献你的时间帮助别人。做一写好事，协助他人，真的能带来许多的快乐和满足给自己。	或者是你也可奉献你的时间帮助别人。做一些好事，协助他人，真的能带来许多的快乐和满足给自己。
大家相信这是意外的因为之前不曾发生过这种事情还有您一定会尽快地解决。	大家相信这是意外的因为之前不曾发生过这种事情还有您一定会尽快地解决。
我们可参观很多有名的博物馆，晚上还可以出门莞儿。	我们可参观很多有名的博物馆，晚上还可以出门玩儿。
我认为这段的「无薪徦」就是上帝给我们的休假。	我认为这段的「无薪假」就是上帝给我们的休假。
我学得不会说不懂中文不好，所以我来台湾学中文。	我觉得不会说不懂中文不好，所以我来台湾学中文。
孩子们更需要机会跟别的儿童接触、交流、玩。因此托儿所是一个很不错的选择。	孩子们更需要机会跟别的儿童接触、交流、玩。因此托儿所是一个很不错的选择。
我妈妈病了，我爸爸过世了，妹妹跟她的男朋友防守了。	我妈妈病了，我爸爸过世了，妹妹跟她的男朋友分手了。
我看我的手摽，时间已经九点半了，我躁诰了。	我看我的手表，时间已经九点半了，我糟糕了。
在美国当然遇到许多困难、坐折，不过我知道为了赚留学费度过多么辛苦的经验。	在美国当然遇到许多困难、挫折，不过我知道为了赚留学费度过多么辛苦的经验。
我今天早上六点办起来了。	我今天早上六点半起来了。
我觉得在网路上很容易不小心打开内容不适合的网页，父母一定不要他们的孩子受到不好的音响。	我觉得在网路上很容易不小心打开内容不适合的网页，父母一定不要他们的孩子受到不好的影响。
根据媒体的报到，他们公司的老板主动地付出自己财产后，登高呼吁著要求大家的参与。	根据媒体的报导，他们公司的老板主动地付出自己财产后，登高呼吁著要求大家的参与。
那也是应该得，毕竟您已经劳累了那么多年，该是我帮忙打理公司的事务了。	那也是应该的，毕竟您已经劳累了那么多年，该是我帮忙打理公司的事务了。
朋友不应该这样：于是我要很认真的跟你说我觉得很不好意思。	朋友不应该这样：于是我要很认真得跟你说我觉得很不好意思。
只要在家里脸上自己学校的网站，就能看得到学生们在教室里的情况。	只要在家里连上自己学校的网站，就能看得到学生们在教室里的情况。
你的身体拿里不好呢？	你的身体哪里不好呢？
有一天８点晚上李大明哏他朋友去跳舞的地方。	有一天８点晚上李大明跟他朋友去跳舞的地方。
祝你周末的愉快。	祝你周末得愉快。
我们区民相信共存共荣将是双赢的局面。	我们居民相信共存共荣将是双赢的局面。
炽爱的大民，你好！	挚爱的大明，你好！
而因有这种想法，孩子会画自地线。	而因有这种想法，孩子会画自地限。
老师介绍自己，然后要救他家轮流介绍。	老师介绍自己，然后要叫大家轮流介绍。
当时我也何你一样很不高兴，不过我跟他讲，如果他有随便坏我是它的权力的话，事情明确揭晓之后向我道歉是疑务。	当时我也和你一样很不高兴，不过我跟他讲，如果他有随便坏我是它的权力的话，事情明确揭晓之后向我道歉是疑务。
本来我打算请你参加我的生日会，跟我们的大学朋友们见面，一边吃饭，一边聊天，没想到你最近的情况这么复杂！	本来我打算请你参加我的生日会，跟我们的大学朋友们见面，一边吃饭，一边聊天，没想到你最近的情况这么复杂！
我的弟弟也很高薪看到你们，因为你们好久不见没看到。	我的弟弟也很高兴看到你们，因为你们好久不见没看到。
下公车的时候，时间快到了，我们只好买吃的东西在马上去电影院。	下公车的时候，时间快到了，我们只好买吃的东西再马上去电影院。
有的表现不好的孩子而且是有很严格的父母，他们回家时一定是被捏或被打一顿，这样他们可台可怜了。	有的表现不好的孩子而且是有很严格的父母，他们回家时一定是被捏或被打一顿，这样他们可太可怜了。
又个很明显的例子：朔胶带，人为了上街方便买东西而发明用的，久之才发现对环境有极大的破坏。	又个很明显的例子：塑胶袋，人为了上街方便买东西而发明用的，久之才发现对环境有极大的破坏。
在教室装摄影机不如给老师与学生特别的安全资料，发生问题的时候让他们很快反映而自己保护。	在教室装摄影机不如给老师与学生特别的安全资料，发生问题的时候让他们很快反应而自己保护。
父母应该合作辅导，照顾孩子，孩子长大以后就花很多钱，除了教育一外就是支持他们喜欢的动作，什么的。	父母应该合作辅导，照顾孩子，孩子长大以后就花很多钱，除了教育以外就是支持他们喜欢的动作，什么的。
因为工厂的噪音很大，邻居谁都觉得非常不舒服。在加上他们遭遇了很多问题。	因为工厂的噪音很大，邻居谁都觉得非常不舒服。再加上他们遭遇了很多问题。
老板不看学校来故新员工，他们看人才。	老板不看学校来雇新员工，他们看人才。
为何女性需要在继续工作呢，研究报告指出，职业中的女性比在家的家庭主妇更会管理她们的时间管理也懂得珍惜时间，因为在外面工作必须遵守一些公司的规定而会有效的应用时间。	为何女性需要再继续工作呢，研究报告指出，职业中的女性比在家的家庭主妇更会管理她们的时间管理也懂得珍惜时间，因为在外面工作必须遵守一些公司的规定而会有效地应用时间。
他年纪大了，在三年就要退休了，从他出社会到现在都在哪家公司上班但是现在变成一无所有。	他年纪大了，再三年就要退休了，从他出社会到现在都在那家公司上班但是现在变成一无所有。
人不能十全十美的，你今天作的事你认为是对的可是在别人的看法可能是错的。	人不能十全十美的，你今天做的事你认为是对的可是在别人的看法可能是错的。
为甚么需要装摄影机是，因为现代的小孩由父母疼爱地甚么都有。	为甚么需要装摄影机是，因为现代的小孩有父母疼爱地甚么都有。
因为太生气了所以我完全不给她留情面、在全班面前谴责她、还想跟她段绝关系。	因为太生气了所以我完全不给她留情面、在全班面前谴责她、还想跟她断绝关系。
可是下个礼拜如果你有空我想再开一个好把？	可是下个礼拜如果你有空我想再开一个好吧？
我门下个里俳才去看电影可以吗？	我们下个礼拜才去看电影可以吗？
所以我觉得每个教室里装了那个影机比较好因为父母可以知道孩子在学校这么样和老师对学生好不好。	所以我觉得每个教室里装了那个影机比较好因为父母可以知道孩子在学校怎么样和老师对学生好不好。
老实讲甚么听不见，考试考得不怎么样，准备过程很辛苦，时间总是不够，所有学校举行的活动都错过了，身体也累坏了，在加上父母担心又生你的气。	老师讲甚么听不见，考试考得不怎么样，准备过程很辛苦，时间总是不够，所有学校举行的活动都错过了，身体也累坏了，再加上父母担心又生你的气。
原来她是上次我迷路的时候帮我的女生。真巧。我跟他说上次很谢谢妳。	原来她是上次我迷路的时候帮我的女生。真巧。我跟她说上次很谢谢妳。
我觉得安装摄影机会影响到孩子的成长，并对家长的抚育观念不利。最后，摄影机可能因起隐私权的法律问题。	我觉得安装摄影机会影响到孩子的成长，并对家长的抚育观念不利。最后，摄影机可能引起隐私权的法律问题。
由于公司面对经济危机，必须大量的减少员工。	由于公司面对经济危机，必须大量地减少员工。
这本书是中文的课本，颜色是蓝色的，书的后面写著我的名子，李大明。	这本书是中文的课本，颜色是蓝色的，书的后面写著我的名字，李大明。
就是从你的作业场发生的音和臭味是对我们不太小的影山。而且我们已经受不了了。	就是从你的作业场发生的音和臭味是对我们不太小的影响。而且我们已经受不了了。
因为他喜欢上网玩游戏而忽略读书，所以大学考了两年都考不上还待了一双近视眼镜。	因为他喜欢上网玩游戏而忽略读书，所以大学考了两年都考不上还戴了一双近视眼镜。
我那是生气得很。他原来骗我，还好意思说出那么难听的话。	我那时生气得很。他原来骗我，还好意思说出那么难听的话。
不知不觉，对网路的依赖变得很重，座在电脑前花的时间已变得更多。	不知不觉，对网路的依赖变得很重，坐在电脑前花的时间已变得更多。
大家都开心起了！真是好美里的一天喔！	大家都开心起了！真是好美丽的一天喔！
我支持家长限制青少年上网时数。青少年还处在发展时期，应该好好的利用他们自己的时间。	我支持家长限制青少年上网时数。青少年还处在发展时期，应该好好地利用他们自己的时间。
对我来说我孩子还不满三岁，就很难找时间去看你的公司，否者的话我们的生活就难过起来了。	对我来说我孩子还不满三岁，就很难找时间去看你的公司，否则的话我们的生活就难过起来了。
前天你刘信给我说你门大学考试玩了。	前天你留信给我说你们大学考试完了。
我认为现在已经是电脑化的时代、摄影机不管在路上或在家里到处都有了、经费也不会很贵阿。	我认为现在已经是电脑化的时代、摄影机不管在路上或在家里到处都有了、经费也不会很贵啊。
她是来事大后看到这个小姐是他的老师。	她是来师大后看到这个小姐是他的老师。
兴建台湾苏花高束公路，对当地居民来说是好事，可是被破坏的生态环境无法挽回，我们需要保留绿色空间。	兴建台湾苏花高速公路，对当地居民来说是好事，可是被破坏的生态环境无法挽回，我们需要保留绿色空间。
我建议的是您们设定最大制造氧气量，如果超过规定的数量，我们可以用法禄处理这些问题等等。	我建议的是您们设定最大制造氧气量，如果超过规定的数量，我们可以用法律处理这些问题等等。
老师说「你现在在莫斯汉堡，你要往后一直走就到了」。	老师说「你现在在摩斯汉堡，你要往后一直走就到了」。
如果你有空，我想这个礼拜五情你去吃饭。	如果你有空，我想这个礼拜五请你去吃饭。
我觉得泰国海边是世界上最骠了地方。	我觉得泰国海边是世界上最漂亮地方。
我的公司是作油压的。而且我当一个组厂压力会很大。	我的公司是作油压的。而且我当一个组长压力会很大。
他去哪家公司也是，为了以后把你的公司经营。	他去那家公司也是，为了以后把你的公司经营。
他后来选择了座计程车去学校。	他后来选择了坐计程车去学校。
我反对他。应为每个人的自由跟权力怎么办？	我反对他。因为每个人的自由跟权利怎么办？
若小孩子从开始已经有了这种习惯，他们在生活里自然而然会把自己大部分的时间花在学习上，这种行为能使他们的未来有好的前途。	若小孩子从开始已经有了这种习惯，他们在生活里自然而然会把自己大部分的时间花在学习上，这种行为能使他们的未来有好的前途。
他原来打算七点钟起床，可是她觉得很累起不来。	他原来打算七点钟起床，可是她觉得很累起不来。
我回越南得时候找工作好找。	我回越南的时候找工作好找。
那天我奇请帖给他她回我信她说她现在找到稳定的一份工作还没有对相喔，看你怎么样喔？	那天我寄请帖给她她回我信她说她现在找到稳定的一份工作还没有对象喔，看你怎么样喔？
因为那个时候是第一次上课，所以他看起来跟老师不开方。	因为那个时候是第一次上课，所以他看起来跟老师不开放。
你也不要失望啊。一般工作学习加曾经验一般学多英语一点。	你也不要失望啊。一边工作学习加增经验一边学多英语一点。
有些父母还推荐孩子去打工，这是为甚么呢？是为了上孩子大开眼界。	有些父母还推荐孩子去打工，这是为甚么呢？是为了让孩子大开眼界。
买了票就近去看电影，看完了我们都觉得这部电影很好看也很好笑，我们很喜欢。	买了票就进去看电影，看完了我们都觉得这部电影很好看也很好笑，我们很喜欢。
以经济发展的名义，人类破坏自然生态的例子已经太多了，无法一一据例。	以经济发展的名义，人类破坏自然生态的例子已经太多了，无法一一举例。
他的老师也觉的他还是聪明，鼓励他高中毕业以后在很有名的大学念书。	他的老师也觉得他还是聪明，鼓励他高中毕业以后在很有名的大学念书。
看这种网路大部分都是学道坏的，有很多理由：有的是想逃避家庭的困难，有的考不上或是失恋．．．所以选这种方法来解决问题。	看这种网路大部分都是学到坏的，有很多理由：有的是想逃避家庭的困难，有的考不上或是失恋．．．所以选这种方法来解决问题。
有别的现代工厂失出了这两个效果，你可以采用他们的办法。	有别的现代工厂使出了这两个效果，你可以采用他们的办法。
后来我学玩了，我搬家到美国西部去。	后来我学完了，我搬家到美国西部去。
上网是很花费时间的，所以青少年只适合少量的接触网路。	上网是很花费时间的，所以青少年只适合少量地接触网路。
如果父母都去上班的话，有可能会不主意不在意孩子。	如果父母都去上班的话，有可能会不注意不在意孩子。
你从算比我爸幸运因为你还算是有工作、有薪水，等全球经济有改善的还是有希望。	你总算比我爸幸运因为你还算是有工作、有薪水，等全球经济有改善了还是有希望。
现在全球那里都受到经济里退的影响，很多人失业或是新水都很低。	现在全球哪里都受到经济衰退的影响，很多人失业或是薪水都很低。
现在女孩子不愿意错过谈恋爱这件美妙的事情，她们一定去参与，因为这样才知道爱是什么？也因使学习了人生中很多经验。	现在女孩子不愿意错过谈恋爱这件美妙的事情，她们一定去参与，因为这样才知道爱是什么？也因此学习了人生中很多经验。
昨天大名跟他的朋友一起去夜店跳舞，可是他忘记昨天是礼拜四。	昨天大明跟他的朋友一起去夜店跳舞，可是他忘记昨天是礼拜四。
若在上班的家长都可以在有一点空档的时候上学校的网站上看看小孩子在教室里的状况以下。	若在上班的家长都可以在有一点空档的时候上学校的网站上看看小孩子在教室里的状况一下。
他主意那个人说的话就到了。	他注意那个人说的话就到了。
那样，你就不但能够享受你喜欢的工作，也可以钻到比较多薪水，支持你的家庭。	那样，你就不但能够享受你喜欢的工作，也可以赚到比较多薪水，支持你的家庭。
噪音方面希望工场方面能多注意、改善。	噪音方面希望工厂方面能多注意、改善。
依人民们记得，自前，你们工厂所发出的噪音没有最近的那么强烈。	依人民们记得，之前，你们工厂所发出的噪音没有最近的那么强烈。
只要你付一笔租金，通过宠物出租公司的面是，并接受养狗训练课程，就可以把小狗租回家玩几天。	只要你付一笔租金，通过宠物出租公司的面试，并接受养狗训练课程，就可以把小狗租回家玩几天。
还有这本书很好看，也不太重业红色的。	还有这本书很好看，也不太重也红色的。
原来你公司实施「无薪假」喔，其实我公司也是受到经济不经济，订单量以及营业额大幅减少。	原来你公司实施「无薪假」喔，其实我公司也是受到经济不景气，订单量以及营业额大幅减少。
最后要告诉您们，如果你们不要处理，我们应该告诉政府，他们会帮我们，所以希望你们自己试试看这么样可以处理，这样不会让您们有问题。	最后要告诉您们，如果你们不要处理，我们应该告诉政府，他们会帮我们，所以希望你们自己试试看怎么样可以处理，这样不会让您们有问题。
所以如果自己的生活太忙，没有时间不要养狗，因为自己的谈心不要害一个活生生的生命。	所以如果自己的生活太忙，没有时间不要养狗，因为自己的贪心不要害一个活生生的生命。
下了课的时候我写功课，做运动，还是跟朋有去玩儿。	下了课的时候我写功课，做运动，还是跟朋友去玩儿。
妳的朋友，障爱文。	妳的朋友，张爱文。
我在奥地利出世，我在难德长大。	我在奥地利出世，我在南德长大。
到新科技的时代，电脑对我们人类实在有很大的贡献。而且在加上网路的功能，把电脑的运作变成更完美。	到新科技的时代，电脑对我们人类实在有很大的贡献。而且再加上网路的功能，把电脑的运作变成更完美。
不过有的人会认为，游戏也是小孩子的一个重要徒径，这样帮他们学习怎么跟别的小孩子沟通、相处等。	不过有的人会认为，游戏也是小孩子的一个重要途径，这样帮他们学习怎么跟别的小孩子沟通、相处等。
不过天气怎么兔然变了，很快天就变黑了。	不过天气怎么突然变了，很快天就变黑了。
你有走到坎坷不平的路，又勇敢又聪，完全是文物双秀。	你有走到坎坷不平的路，又勇敢又聪，完全是文武双秀。
最后，我很早就有了我自己的规划。已经投入了不少时间与力气。如果现在把一切所做的事放妻，那就会半途而废，会太可惜了！	最后，我很早就有了我自己的规划。已经投入了不少时间与力气。如果现在把一切所做的事放弃，那就会半途而废，会太可惜了！
我偷偷轻去，老师看到我，她就生气了。	我偷偷进去，老师看到我，她就生气了。
我觉得你可以利用空堂时间，找个家教、临时打工也不错，或著利用现在多多休息，等到经济恢复经济之后，在努力工作就可以的。	我觉得你可以利用空档时间，找个家教、临时打工也不错，或者利用现在多多休息，等到经济恢复经济之后，再努力工作就可以的。
他们决定下雨太大了，没有办法几希在外面烤肉。	他们决定下雨太大了，没有办法继续在外面烤肉。
我妈妈很息缓喝台湾的茶和衣服。	我妈妈很喜欢喝台湾的茶和衣服。
我听说日本又漂亮的衣服。我不怎们喜欢台湾的衣服，所以要是你麻烦帮我忙，我真很高兴。	我听说日本有漂亮的衣服。我不怎么喜欢台湾的衣服，所以要是你麻烦帮我忙，我真很高兴。
他吃了晚餐之后马上到房间里拼命的念书到隔天早上。	他吃了晚餐之后马上到房间里拼命地念书到隔天早上。
因为他们也觉得养那只狗只暂时而以所以也不用培养感他们跟小狗的感情，反正不久他也非送那只狗回去不可。	因为他们也觉得养那只狗只暂时而已所以也不用培养感他们跟小狗的感情，反正不久他也非送那只狗回去不可。
建置不可理喻，一直强词夺理、重重伤害我妈妈的自尊心，后来经过检证之后终于还了我妈妈一个清白。	简直不可理喻，一直强词夺理、重重伤害我妈妈的自尊心，后来经过检证之后终于还了我妈妈一个清白。
因为当父母的小孩要有责任，钸弹在家而随时随地都要有责任，不是只有松小孩交给老师就好。	因为当父母的小孩要有责任，不但在家而随时随地都要有责任，不是只有送小孩交给老师就好。
在台湾有一个外国人，他要去市大学校但是他不知道市大学校在哪儿，因为他不会说中文还有念中国字也看不懂。	在台湾有一个外国人，他要去师大学校但是他不知道师大学校在哪儿，因为他不会说中文还有念中国字也看不懂。
我们没有做错事的，我们做的认真，一定有结果的！	我们没有做错事的，我们做得认真，一定有结果的！
教师是一个公共场所又不是私人场所，因此安装摄影机不会干涉任何人的私人空间。	教室是一个公共场所又不是私人场所，因此安装摄影机不会干涉任何人的私人空间。
我希望你神病快好，你要吃多水果，以后我们可以一起吃饭。	我希望你生病快好，你要吃多水果，以后我们可以一起吃饭。
我很久时间等了帮忙我的人，所以高兴的不得了。	我很久时间等了帮忙我的人，所以高兴得不得了。
因为我小孩的个性很挑皮我怕他不听老师的话也不认真的读书。	因为我小孩的个性很调皮我怕他不听老师的话也不认真的读书。
在俄罗斯这样的情况处处可见，不过实地说这些打工的人并不是来自贫穷的家庭。	在俄罗斯这样的情况处处可见，不过实在说这些打工的人并不是来自贫穷的家庭。
因该说不是网路或上网的问题，是管理时间、平衡行为的问题。	应该说不是网路或上网的问题，是管理时间、平衡行为的问题。
李大明喝很多酒也跳五跟他的朋友们。	李大明喝很多酒也跳舞跟他的朋友们。
不少主人别常常早出门晚回就不为好好地照顾他们租的养狗。	不少主人别常常早出门晚回就不会好好地照顾他们租的养狗。
不过～我没想到那天有一个很特别的板球！	不过～我没想到那天有一个很特别的棒球！
我来代表邻居门跟您讨论一下关于您们工厂发出的嗓音和臭味。	我来代表邻居们跟您讨论一下关于您们工厂发出的噪音和臭味。
如果从小的时候小孩觉得大人都不相信他们，那他们以后不会变成好的大人马？	如果从小的时候小孩觉得大人都不相信他们，那他们以后不会变成好的大人吗？
假设是我们，一旦知道我们的一举一动都有人观茶，我们会有怎么样的感觉？	假设是我们，一旦知道我们的一举一动都有人观察，我们会有怎么样的感觉？
结果，医生跟我们说那些才有喷农药，不适合人吃的。	结果，医生跟我们说那些菜有喷农药，不适合人吃的。
要是我们上课的时候说话，我的老师说对我们：「建在不必说话！」	要是我们上课的时候说话，我的老师说对我们：「现在不必说话！」
可是我们真不愿意这个。而且真希望继续会你的好好的璘住。	可是我们真不愿意这个。而且真希望继续会你的好好的邻居。
我考完试，我们在一起去看电影吧！	我考完试，我们再一起去看电影吧！
以前的青少年没有自己的手机由电脑，可是现在我觉得没有这种机器的人不多。	以前的青少年没有自己的手机有电脑，可是现在我觉得没有这种机器的人不多。
我个人想法是：不抡大人或是小朋友都要有自己的时间，空间，上课的时间是让学生有老师来教导，而不是连爸爸妈妈也时时刻刻在管他们！	我个人想法是：不论大人或是小朋友都要有自己的时间，空间，上课的时间是让学生有老师来教导，而不是连爸爸妈妈也时时刻刻在管他们！
因为山上的空气比那理很好。	因为山上的空气比那里很好。
一天到晚在自之的职场辛苦地工作回到家没有人来迎他会使他感到凄凉。	一天到晚在自己的职场辛苦地工作回到家没有人来迎他会使他感到凄凉。
可是到现在为止还有的人小看女生。这些情况在各各社会方面明显地看得出来。	可是到现在为止还有的人小看女生。这些情况在各个社会方面明显地看得出来。
对不起老师，今天早上我的婆婆神病，所以我要带他去看医生。	对不起老师，今天早上我的婆婆生病，所以我要带他去看医生。
如果我有功课的话，我打算做功课，我让同学教，我后天给你提出。	如果我有功课的话，我打算做功课，我让同学教，我后天给你提出。
我因该学习法文，因为我明天有法文的考试。	我应该学习法文，因为我明天有法文的考试。
这是即创意又安全控制孩子的方法	这是既创意又安全控制孩子的方法
谢谢你们寄给我绍待卡，我很高兴。	谢谢你们寄给我招待卡，我很高兴。
电话号吗：０９８７－３３３－００４。	电话号码：０９８７－３３３－００４。
教育的责任，不止在学校的教师这边，在家里的家长与社会的民众都有很大的责任。	教育的责任，不只在学校的教师这边，在家里的家长与社会的民众都有很大的责任。
营为他们在书店三个钟头，所以我弟弟此他朋友来我们的家吃饭。	因为他们在书店三个钟头，所以我弟弟请他朋友来我们的家吃饭。
第一是他很喜欢工作，第二枚天准时的人，第三很努力，第四非常责任，最后是他的耐烦很大。	第一是他很喜欢工作，第二每天准时的人，第三很努力，第四非常责任，最后是他的耐烦很大。
在瞅天，天气不热也不冷。	在秋天，天气不热也不冷。
他问用英文「台湾大学在哪哩？」她很客气，还有会说英文。	他问用英文「台湾大学在哪里？」她很客气，还有会说英文。
我从小一直看著你经营公司的样子。所以知道经营公司真的不简单，很幸苦。	我从小一直看著你经营公司的样子。所以知道经营公司真的不简单，很辛苦。
但我们的目的还是相同的，也是为了家庭根社会做贡献，而只是得到目的的方法不一样。	但我们的目的还是相同的，也是为了家庭跟社会做贡献，而只是得到目的的方法不一样。
从这样的故事上我要推荐你门上网交朋友，可是注意自己的安全。	从这样的故事上我要推荐你们上网交朋友，可是注意自己的安全。
附近的诊所表达，该症状的患者日应增加。	附近的诊所表达，该症状的患者日益增加。
而且聊天的时间是很难控制，每天都把自己宝贵的五、六个小时花光了缺不知道，是一件很容易发生的事情。	而且聊天的时间是很难控制，每天都把自己宝贵的五、六个小时花光了却不知道，是一件很容易发生的事情。
我赠经过这种经验。我结婚以前有好的工作。我舍不得辞职，所以我继续工作，孩子生了很多问题出来，我要找伯母，安排甚嚜等等。	我曾经过这种经验。我结婚以前有好的工作。我舍不得辞职，所以我继续工作，孩子生了很多问题出来，我要找褓母，安排甚么等等。
我们晒的衣服也被你们的臭味占了，之后，我们再用力的洗衣服总会有淡淡的臭味，我们受够了。	我们晒的衣服也被你们的臭味脏了，之后，我们再用力地洗衣服总会有淡淡的臭味，我们受够了。
住在大成市的人，他们平常很忙，有的人有时也没有时间照顾自己所以自己要养狗、猫也觉得很麻烦。	住在大城市的人，他们平常很忙，有的人有时也没有时间照顾自己所以自己要养狗、猫也觉得很麻烦。
首先，很抱羡已经跟你说这种实话实说的我，最近李先生的厂长发生两件事情，不仅令我的家人觉得很不方便，连我的邻居也觉得非常懊恼。	首先，很抱歉已经跟你说这种实话实说的我，最近李先生的厂长发生两件事情，不仅令我的家人觉得很不方便，连我的邻居也觉得非常懊恼。
你们老是不知道他们要认真的交朋友或是跟你们玩。	你们老师不知道他们要认真的交朋友或是跟你们玩。
产品，飞机表，都在网路卖得到的，而且价格比价便宜。	产品，飞机表，都在网路买得到的，而且价格比较便宜。
自己的小孩看到家长来会撞得更可怜（人的本性），老师没办法去需教学下去，还有很多问题会发生。	自己的小孩看到家长来会装得更可怜（人的本性），老师没办法继续教学下去，还有很多问题会发生。
请你要是你在日本看，清卖给我。	请你要是你在日本看，请买给我。
我们玩著玩者就睡觉了。	我们玩著玩著就睡觉了。
看教室的情况让父母安全，他们知道他们的孩子这么样。	看教室的情况让父母安全，他们知道他们的孩子怎么样。
根据上面的原因，家长要限制小孩子的上网时数，教他们怎么用网路学习，不要让他们米上没有用的东西。	根据上面的原因，家长要限制小孩子的上网时数，教他们怎么用网路学习，不要让他们迷上没有用的东西。
换句话来说，透过电脑来交朋友就可帮助人更诚实得联络。	换句话来说，透过电脑来交朋友就可帮助人更诚实地联络。
他们跟我说出去的时候不想出去因为问到不知道从哪里来的臭味，在外面吃饭的时候没有胃口吃，甚至买菜的时候，也发现有稍微工厂污染的臭味。	他们跟我说出去的时候不想出去因为闻到不知道从哪里来的臭味，在外面吃饭的时候没有胃口吃，甚至买菜的时候，也发现有稍微工厂污染的臭味。
特别是到用餐时间闻到这些味道使我们都吃不下东西，各各的健康都出了问题。	特别是到用餐时间闻到这些味道使我们都吃不下东西，个个的健康都出了问题。
对于如何处理妥当这两件事情，我想身为个大老板，我相信这两件事情对您老说是没问题的。	对于如何处理妥当这两件事情，我想身为个大老板，我相信这两件事情对您来说是没问题的。
因为真的每一个母亲很担心小孩子在那斌他有没有问题，我希望这种想法会成功。	因为真的每一个母亲很担心小孩子在那边他有没有问题，我希望这种想法会成功。
最近，很多人渐渐的抱怨说您的工厂造成过度的澡音与臭味。	最近，很多人渐渐的抱怨说您的工厂造成过度的噪音与臭味。
只要更多的人支持职业妇女让他继续工作，才能实现理想的社会。	只要更多的人支持职业妇女让她继续工作，才能实现理想的社会。
我听说，你找到新工作，我很高兴。	我听说，你找到新工作，我很高兴。
一个噪音、臭味都没有制造是不可能的，很小的造，臭味的话我们可以接受，可是我希望你们会做出努力减少这些公害。	一个噪音、臭味都没有制造是不可能的，很小的噪，臭味的话我们可以接受，可是我希望你们会做出努力减少这些公害。
因此我觉得在每一个教室装摄影机不但有坏处，也有一点夸装。	因此我觉得在每一个教室装摄影机不但有坏处，也有一点夸张。
她到来他的客看老是，他说走路很快所以他很累。	她到来他的课看老师，他说走路很快所以他很累。
我们也会有很好的雅量来接受这件事，您们也要像我们的徒劳，做出对两者很好的生活环境。	我们也会有很好的雅量来接受这件事，您们也要想我们的苦劳，做出对两者很好的生活环境。
辛亏他来台湾前，已经准备了一个台湾的地图。	幸亏他来台湾前，已经准备了一个台湾的地图。
由工厂发的闹音跟臭味过大，那有些宝贝不会睡觉著一直哭、大人也对身体和精神的影响不小。	由工厂发的闹音跟臭味过大，让有些宝贝不会睡觉著一直哭、大人也对身体和精神的影响不小。
应为今天是第一天，老师先请学生自己给介绍。	因为今天是第一天，老师先请学生自己给介绍。
我想信弟弟会更对应你的期望，来继续处理你建立的公司。谢谢你的信任。	我相信弟弟会更对应你的期望，来继续处理你建立的公司。谢谢你的信任。
那位帮我找到学校的小姐原来是我的中文老师！真巧呕！	那位帮我找到学校的小姐原来是我的中文老师！真巧喔！
让后我们也会帮您们如何可以处理，还是我们要给您们介意。	然后我们也会帮您们如何可以处理，还是我们要给您们建议。
上次我们举办理会的时候，一个代表委员提出一个意见关于贵工厂的。	上次我们举办里会的时候，一个代表委员提出一个意见关于贵工厂的。
由于下午五点后区民都与其小孩相当疲累，但回家之后却又被您方的噪音困扰。	由于下午五点后居民都与其小孩相当疲累，但回家之后却又被您方的噪音困扰。
事情过了他们也不生我的气了，但是只有那个朋有是一直没跟我说话。	事情过了他们也不生我的气了，但是只有那个朋友是一直没跟我说话。
上课一后，我真的很高兴因为我的老师是一前的那个小姐。	上课以后，我真的很高兴因为我的老师是以前的那个小姐。
上个周末有空，我会去看你。	上个周末有空，我会去看你。
我觉得从你们的工厂来得臭味里应该有对我们的身体不好的化学的物质。所以可能对我们的健康不好。	我觉得从你们的工厂来的臭味里应该有对我们的身体不好的化学的物质。所以可能对我们的健康不好。
在我的亲眼经验下宪环保法律不一定会停止污染，在当地如果没有控制部门，法律就相当于没有了。	在我的亲眼经验下限环保法律不一定会停止污染，在当地如果没有控制部门，法律就相当于没有了。
你记得的我们的母语是西办加话，可是服务生大部分都听的懂一点点英文。	你记得的我们的母语是西班牙话，可是服务生大部分都听的懂一点点英文。
第一个象片儿：这个男人刚起床。	第一个相片儿：这个男人刚起床。
我们最近也感觉得到很多的苦衷，我们已经忍的很久才会写这封信的。	我们最近也感觉得到很多的苦衷，我们已经忍了很久才会写这封信的。
宣称是家长在家的时候连上学校的网站，就能看到小孩上课的情行。	宣称是家长在家的时候连上学校的网站，就能看到小孩上课的情形。
我慢慢习惯台湾的生活，式式看台湾野餐，也找的到了天主教的教堂，所以可以去中文弥撒。	我慢慢习惯台湾的生活，试试看台湾野餐，也找得到了天主教的教堂，所以可以去中文弥撒。
对阿，我们快烤肉吧！	对啊，我们快烤肉吧！
我学得中国字很有意思。	我觉得中国字很有意思。
到教室之后老是看到大明迟到，就骂他了很大声。	到教室之后老师看到大明迟到，就骂他了很大声。
恭喜妳们永远幸福，早生孩子，恭喜恭喜。	恭喜你们永远幸福，早生孩子，恭喜恭喜。
看著电影，大名要说给他知道她很喜欢她，所以他现在不要去上课，就要去电影院。	看著电影，大明要说给他知道她很喜欢她，所以他现在不要去上课，就要去电影院。
我认为正规的教育，是可以训练团体生活、与人际关系的沟通。	我认为正规的教育，是可以训练团体生活、与人际关系的沟通。
对你我们的建议是，「请您不要随地方垃圾」。	对你我们的建议是，「请您不要随地放垃圾」。
我们的同学跟我说你神病，你怎么样？	我们的同学跟我说你生病，你怎么样？
我很高兴你们结婚了，难怪热心的不得了。	我很高兴你们结婚了，难怪热心得不得了。
整个社区已经臭味薰天，连待在家里都得戴上口罩！吃饭的时候连食物喂都不见了，换来闻到的都是工业臭味。	整个社区已经臭味薰天，连待在家里都得戴上口罩！吃饭的时候连食物味都不见了，换来闻到的都是工业臭味。
如果您找，请你跟李大明联络或换给办公室的服务。	如果您找，请你跟李大明联络或还给办公室的服务。
随之社会的进步及竞争，还有物价不断的攀升导致生活更有挑战。	随著社会的进步及竞争，还有物价不断地攀升导致生活更有挑战。
他有没有希望有一天他不需要上班，会带在家里，做他爱做的事情。	她有没有希望有一天她不需要上班，会待在家里，做她爱做的事情。
我们都知道这个：「孩子是我们的将开」的说法。	我们都知道这个：「孩子是我们的将来」的说法。
因为我有近视，所以上课的时候就座在教室的前面，要不然老师写的字都会看不清楚。	因为我有近视，所以上课的时候就坐在教室的前面，要不然老师写的字都会看不清楚。
那本是美国的坻里。	那本是美国的地理。
可是，说到妳同班同学被偷东西，我认为他的行为间直可笑。	可是，说到妳同班同学被偷东西，我认为他的行为简直可笑。
可是如果教室里装摄影机的话，家常们会正确地判断孩子的好处或该改善的地方是什么。	可是如果教室里装摄影机的话，家长们会正确地判断孩子的好处或该改善的地方是什么。
每次回到家里，都还要戴上口罩及耳塞，设为感想？	每次回到家里，都还要戴上口罩及耳塞，社会感想？
我忘记了那个臭味！工厂让全部附近都超级抽。	我忘记了那个臭味！工厂让全部附近都超级臭。
我们都知道你的工厂工作的很稳定，这几年以来你们的展品在世界上非常有名。	我们都知道你的工厂工作的很稳定，这几年以来你们的产品在世界上非常有名。
华连台湾美景，很多台湾特有的动植物在那生长，苏华高速公路切过那地方，多多少少自然环境受影响、生态系平衡被破坏。	花莲台湾美景，很多台湾特有的动植物在那生长，苏花高速公路切过那地方，多多少少自然环境受影响、生态系平衡被破坏。
如果现在这种事情还在我身胜发生，我想我也不会因为他而影响到我现实的生活，我们清白就不用怕委屈啦！	如果现在这种事情还在我身上发生，我想我也不会因为他而影响到我现实的生活，我们清白就不用怕委屈啦！
我自认为小学的校长装摄影机没有作法。	我自认为小学的校长装摄影机没有做法。
下午三点，他们外面的时候，有很大的下与。	下午三点，他们外面的时候，有很大的下雨。
我觉得校长的作法对家长、孩子跟学校都不好。	我觉得校长的做法对家长、孩子跟学校都不好。
在台湾学生能够专注学习以及获得专业实施寒食机能力对学生本身的未来甚至于整国家发展的趋向有重大的影响。	在台湾学生能够专注学习以及获得专业实施和实际能力对学生本身的未来甚至于整国家发展的趋向有重大的影响。
全世界国家意示到自然的重要性。	全世界国家意识到自然的重要性。
应为天气那么好，王天华跟他的非洲与台湾朋友决定坐２９７公车去乡下玩。	因为天气那么好，王天华跟他的非洲与台湾朋友决定坐２９７公车去乡下玩。
第二个象片儿：四个学生都在教室。	第二个相片儿：四个学生都在教室。
生活吧，作人当然要经过各种各样的事，也要遇见各种各样的人格。	生活吧，做人当然要经过各种各样的事，也要遇见各种各样的人格。
我们在报子上、新闻上常常可以看到人为了发展经济迫破害了大自然。	我们在报纸上、新闻上常常可以看到人为了发展经济迫破害了大自然。
明天我的父母从日本来的，而且他们第一次来台湾，所以我应该跟父母一起去台南跟高雄的游览。	明天我的父母从日本来的，而且他们第一次来台湾，所以我应该跟父母一起去台南跟高雄的游览。
祝爸八身体健康，快乐！	祝爸爸身体健康，快乐！
他站在公车上站著沾著，忽然一个奴生叫他在她的椅子坐一下。	他站在公车上站著站著，忽然一个女生叫他在她的椅子坐一下。
总之而言，环境是人类需要的基本要求和因素，它是为了我们的人类不断得牺牲。	总之而言，环境是人类需要的基本要求和因素，它是为了我们的人类不断地牺牲。
但是先在的社会里，女人的地位已经不同了。	但是现在的社会里，女人的地位已经不同了。
我们喝了很多可乐，吃了很多东西，可是我也喝了两杯啤酒，所以我很高心。	我们喝了很多可乐，吃了很多东西，可是我也喝了两杯啤酒，所以我很高兴。
比如：空气，水等，真的我门生活当中不可缺少的东西。	比如：空气，水等，真的我们生活当中不可缺少的东西。
一个用有基本知识和创意的下代才会让以后的社会更美好更进步。	一个拥有基本知识和创意的下代才会让以后的社会更美好更进步。
明天我给你打电话，请你告诉我我们的公克，谢谢。	明天我给你打电话，请你告诉我我们的功课，谢谢。
我们也要求钱帮我们洗张湖乡下，也帮伤害的人付他们议员费。	我们也要求钱帮我们洗张湖乡下，也帮伤害的人付他们医院费。
比方说，假如孩子们知道一直被拍到，会让他们的压力更大。台湾学生得负担的压力已经像目前的这么大，在加上可能就是断骆驼的背之根麦。	比方说，假如孩子们知道一直被拍到，会让他们的压力更大。台湾学生得负担的压力已经像目前的这么大，再加上可能就是断骆驼的背之根麦。
如果每个学校有自己的网站，我们可以上网看当天或者前几天课的录音。	如果每个学校有自己的网站，我们可以上网看当天或者前几天课的录影。
不过话说回来，我觉得有的服务事不应该商业化的。	不过话说回来，我觉得有的服务是不应该商业化的。
孩子还是很小，还是不够董事，甚么事情其实有爸妈管还是比较好。	孩子还是很小，还是不够懂事，甚么事情其实有爸妈管还是比较好。
看车来了，他吧手问开车的人停车了。	看车来了，他把手问开车的人停车了。
学生每天收到不好的影响，比如说：暴力的电影，在新闻常常看警察不能抓坏人，社会鼓励大家不关系别人，甚么的。	学生每天受到不好的影响，比如说：暴力的电影，在新闻常常看警察不能抓坏人，社会鼓励大家不关心别人，甚么的。
听说这一次你的感冒很严重，区急诊部。	听说这一次你的感冒很严重，去急诊部。
也雪今天他上课，还是他上班，我不知道。	也许今天他上课，还是他上班，我不知道。
所以我鼓励您跟我一起解决我们有的问题为了你们好好地做生意，还有为了我跟我的家人又很快乐的生活。	所以我鼓励您跟我一起解决我们有的问题为了你们好好地做生意，还有为了我跟我的家人有很快乐的生活。
敬祝身体建慷。	敬祝身体健康。
我已经进入时会几年了，我有自己的计划，自己的目标等等。	我已经进入社会几年了，我有自己的计划，自己的目标等等。
如果你有孔，请你打电话给我，告诉我什么时候你有空。	如果你有空，请你打电话给我，告诉我什么时候你有空。
吃了早菜以后他去上课。	吃了早餐以后他去上课。
事务有好坏之分，选择有胜败之差；你的选择让你活出明天了吗？	事物有好坏之分，选择有胜败之差；你的选择让你活出明天了吗？
或来我不敢很晚回家，要用功一点。	后来我不敢很晚回家，要用功一点。
除此久外，宠物出租公司还提供养狗训练课程，因此我们就能以正确的方法来养小狗。	除此之外，宠物出租公司还提供养狗训练课程，因此我们就能以正确的方法来养小狗。
现在早上六点半，这个男孩子再起床呢。	现在早上六点半，这个男孩子在起床呢。
她的公司面对破算的危险，他的公司告诉她不需要去上班，因为你一样的事情。公司给她两个月的放假。	她的公司面对破算的危险，她的公司告诉她不需要去上班，因为你一样的事情。公司给她两个月的放假。
他们在餐厅吃好好的菜，然后她男朋友代去上海有名的地方。	他们在餐厅吃好好的菜，然后她男朋友带去上海有名的地方。
我最喜欢的课目是数学。	我最喜欢的科目是数学。
从学校一回来，男生女生们都会上各自的部落各，写下当时的感情，或是当天在学校看到的事情。	从学校一回来，男生女生们都会上各自的部落格，写下当时的感情，或是当天在学校看到的事情。
我觉得你们用的机器都不太欣，有很多问题，你们可以去到你们买机器的公司问问他们怎么样可以修理。	我觉得你们用的机器都不太行，有很多问题，你们可以去到你们买机器的公司问问他们怎么样可以修理。
那们多人高中、初中、甚至于小学都没毕业，他们靠自己的人才和实力赚钱。	那么多人高中、初中、甚至于小学都没毕业，他们靠自己的人才和实力赚钱。
我的老实说「你比希用功」。	我的老师说「你必须用功」。
还有，小孩子下午要睡觉的时候，他每次睡不著。所以他的妈妈很困。	还有，小孩子下午要睡觉的时候，他每次睡不著。所以他的妈妈很困。
我告诉你我们年记也不小了有工作找一个好帮手就像给爸妈一个交代就圆满了。	我告诉你我们年纪也不小了有工作找一个好帮手就算给爸妈一个交代就圆满了。
我想要喝的东西，我餲得不得了。	我想要喝的东西，我渴得不得了。
我把一本书在图书馆三楼的逃论室里弄丢了。	我把一本书在图书馆三楼的讨论室里弄丢了。
孩子做不好的事情，他们可能有心理上的问题或烦恼。如果，早就知道，应该来得起对他们的帮助。	孩子做不好的事情，他们可能有心理上的问题或烦恼。如果，早就知道，应该来得及对他们的帮助。
为了国家未来的栋梁著想，家长限制青少年上网的时数绝对是有益无损的。	为了国家未来的栋梁著想，家长限制青少年上网的时数绝对是有益无损的。
可是我觉得做这样子对我的身体也好、对环境也好、在加上对地球也好。	可是我觉得做这样子对我的身体也好、对环境也好、再加上对地球也好。
我有一位在世界展望会工作的朋友想让你认识，他非常的有爱心，几乎每个礼拜都会上山，帮助部落的灾区们，他说他想你聊一聊。	我有一位在世界展望会工作的朋友想让你认识，他非常地有爱心，几乎每个礼拜都会上山，帮助部落的灾区们，他说他想你聊一聊。
这些现象对青少年身体何心理造成不良的影响。	这些现象对青少年身体和心理造成不良的影响。
他们就大工，赚少钱，付房助以后（在法国，我们喜欢早离开家，多独立，跟台湾人并不一样）没有那么多钱，得问父母的帮忙。	他们就大工，赚少钱，付房租以后（在法国，我们喜欢早离开家，多独立，跟台湾人并不一样）没有那么多钱，得问父母的帮忙。
现在科技发展全球的咨询传输很快，我们在地球一个角落都可以知道世界上哪地方发生灾难。	现在科技发展全球的资讯传输很快，我们在地球一个角落都可以知道世界上哪地方发生灾难。
小美跟我一样大，可是沾起来的时候我比她高。	小美跟我一样大，可是站起来的时候我比她高。
他的好朋友叫文得，他们常常下可以后一起去看电影。	他的好朋友叫文得，他们常常下课以后一起去看电影。
有人提起「隐私权」的问题，但然了解他们的想法，但跟小孩的学校生活安全比起来哪一个是重要呢？	有人提起「隐私权」的问题，当然了解他们的想法，但跟小孩的学校生活安全比起来哪一个是重要呢？
昨天晚上，李大明请了一个好朋友来他家为了一起看一个棒球比塞。	昨天晚上，李大明请了一个好朋友来他家为了一起看一个棒球比赛。
臭味对身体也非常不健康，我们最近不能欢迎朋友来我们的家，应为我们怕他们可能受不了我们的家庭环境。	臭味对身体也非常不健康，我们最近不能欢迎朋友来我们的家，因为我们怕他们可能受不了我们的家庭环境。
下了课我们常常以起坐公车。今天我们也以块去了。	下了课我们常常一起坐公车。今天我们也一块去了。
不久下了大雨，害他们手忙脚乱找不林雨的地方。	不久下了大雨，害他们手忙脚乱找不淋雨的地方。
放完家就回来忙碌的单身贵族。从我的心愿和想法来看，我想很多人也会同情，而且喜欢上这个的兴行业。	放完假就回来忙碌的单身贵族。从我的心愿和想法来看，我想很多人也会同情，而且喜欢上这个的新行业。
请爱李大明和林小美，谢谢邀请我妳们的婚龄。	亲爱李大明和林小美，谢谢邀请我妳们的婚礼。
我迷路了。所以你可以戴我去火车站，好吗？	我迷路了。所以你可以载我去火车站，好吗？
我们打算开一个些日会。	我们打算开一个生日会。
装录音机在每个教室里有很多的好处，对我来说庄录影机在教室里的好处比坏处多了。	装录影机在每个教室里有很多的好处，对我来说装录影机在教室里的好处比坏处多了。
希望李工厂可以听我们说话，亭很噪的工作。	希望李工厂可以听我们说话，停很吵的工作。
早知道他是老是，说不定可以跟他一起来学校，他很高兴老是对他非常好。	早知道他是老师，说不定可以跟他一起来学校，他很高兴老是对他非常好。
公司针对无薪假实行部份现在公司的经济状况不是那么佳，所以我们大家都即忍耐，也坚持这段困恼的时间。	公司针对无薪假实行部份现在公司的经济状况不是那么佳，所以我们大家都既忍耐，也坚持这段困扰的时间。
改天我们一直走，好不好？	改天我们一起走，好不好？
照这个广告来说我们可以租几天时间狗让我们了解狗狗的习惯各性等等。	照这个广告来说我们可以租几天时间狗让我们了解狗狗的习惯个性等等。
你好！我是张爱文。	你好！我是张爱文。
也许你的同学已经知道他的行为有偏差，那时后他不应该检察你的东西。	也许你的同学已经知道他的行为有偏差，那时后他不应该检查你的东西。
可是，因为您的工厂坐落在居民附近所以也导致了不少问题。	可是，因为您的工厂座落在居民附近所以也导致了不少问题。
我知道您是很聪明的人还有您非常关系别人的问题，所以我希望您帮助我们。	我知道您是很聪明的人还有您非常关心别人的问题，所以我希望您帮助我们。
我很想跟去，可是没办法有考试，我希望你的流星很好玩！	我很想跟去，可是没办法有考试，我希望你的旅行很好玩！
跟据调查，青少年平均上网时间超过看书或看电视。	根据调查，青少年平均上网时间超过看书或看电视。
最后我门要来餐店吃饭。	最后我们要来餐店吃饭。
你最抽大麻有兴趣吗？你要不要我送免费的给你呢？	你对抽大麻有兴趣吗？你要不要我送免费的给你呢？
第三个象片儿：两个人都坐公共汽车还是昨坐火车。	第三个相片儿：两个人都坐公共汽车还是昨坐火车。
因为庆祝会那天是我妈妈的生日。我要去乡下间妈妈。	因为庆祝会那天是我妈妈的生日。我要去乡下见妈妈。
最后，我建议厂长尽快跟我们民众联络或者亲自来我们这边来亲眼看当地情况如何。	最后，我建议厂长尽快跟我们民众联络或者亲自来我们这边来亲眼看当地情况如何。
影机也可以给老师看所以他们知道他们教得这么。	影机也可以给老师看所以他们知道他们教得怎么。
我有一个朋友、他应该帮我们处理这些问题．．．我觉得您不要这样子把。我等您回复。	我有一个朋友、他应该帮我们处理这些问题．．．我觉得您不要这样子吧。我等您回复。
去医院之后一声说，很吵的环境平常对小朋友的身体有很大的影响。	去医院之后医生说，很吵的环境平常对小朋友的身体有很大的影响。
谢谢看我的意见，而且请你考虑我的意见以下。	谢谢看我的意见，而且请你考虑我的意见一下。
尤其是有些私立小学还装了摄影机，这样的话，家长只要在家里连长那所学校的网站，就能看到孩子遭教室里的情况。	尤其是有些私立小学还装了摄影机，这样的话，家长只要在家里连上那所学校的网站，就能看到孩子在教室里的情况。
最近我听说我孩子的小学的校长只是在每个教室里装了影几，我觉得有点担心。	最近我听说我孩子的小学的校长只是在每个教室里装了影机，我觉得有点担心。
天华知道我喜欢吃烤肉，所已需要的东西她都准备好了。	天华知道我喜欢吃烤肉，所以需要的东西她都准备好了。
最后希望您能够听到居民们的心听，尽快给我们一个合理的处里方案，还给居民一个安静的生活环境。	最后希望您能够听到居民们的心听，尽快给我们一个合理的处理方案，还给居民一个安静的生活环境。
教师有在教室里教学问且指导学生的权利，但若装摄影机就另教师感觉到一直被别人监视，导致教师过度紧张或不舒服。	教师有在教室里教学问且指导学生的权利，但若装摄影机就令教师感觉到一直被别人监视，导致教师过度紧张或不舒服。
针对于宠物出租我个人非常同意，因为省时间天天去照顾，而且省钱天天为牠吃，有出租宠物的机会当然非常好，想念牠的时候就可以带回家，然后不想养或著工作忙碌的时候没办法照顾，就可以送走。	针对于宠物出租我个人非常同意，因为省时间天天去照顾，而且省钱天天为牠吃，有出租宠物的机会当然非常好，想念牠的时候就可以带回家，然后不想养或者工作忙碌的时候没办法照顾，就可以送走。
除此「教室的摄影机」伟反了个人的自由权及隐私权外，法律上的条例亦尚未指定此事。	除此「教室的摄影机」违反了个人的自由权及隐私权外，法律上的条例亦尚未指定此事。
如果没处理，我们就没办法可能要去仅差距报告。	如果没处理，我们就没办法可能要去警察局报告。
若家长能够看到教室里所发生的情况，可能不同意老师的作法。	若家长能够看到教室里所发生的情况，可能不同意老师的做法。
我要做一个很大的生日会，所以下星期六握著我的朋友我家来。	我要做一个很大的生日会，所以下星期六我找我的朋友我家来。
现代的生活因为少子化的关系所以现在的人往往不想生孩子，但是有怕孤独的他们就会想养宠物来陪伴。	现代的生活因为少子化的关系所以现在的人往往不想生孩子，但是又怕孤独的他们就会想养宠物来陪伴。
从小你教了我如何付责任、省钱及为了自己的梦想努力。	从小你教了我如何负责任、省钱及为了自己的梦想努力。
希望您能够以认真的态度面对这些问题且提出处里方案。	希望您能够以认真的态度面对这些问题且提出处理方案。
针对教育关点上，我看法是不好的管教方法，我们我活上也是一样，主管管太豁或著有人每天都官查，心里上也很紧张，大人是这样，小孩应概也很紧张。	针对教育观点上，我看法是不好的管教方法，我们我活上也是一样，主管管太多或者有人每天都观察，心理上也很紧张，大人是这样，小孩应该也很紧张。
你单让知道我的家在那里。	你当然知道我的家在那里。
一半来说他们忙不过来。他们认为在网路上找到朋友是一个很好的机会。	一般来说他们忙不过来。他们认为在网路上找到朋友是一个很好的机会。
因为炸之后直接放在客人的前面，所以外面的皮很松，很好吃。	因为炸之后直接放在客人的前面，所以外面的皮很松，很好吃。
在很多家经营网咖店，集中了很多青少年，整天不眠不休的上网，迷到有时还忘了饮食呢！	在很多家经营网咖店，集中了很多青少年，整天不眠不休地上网，迷到有时还忘了饮食呢！
但是，他们的老板想出一个办法，他决定训练自己的成员，让他们更进一步的发展。	但是，他们的老板想出一个办法，他决定训练自己的成员，让他们更进一步地发展。
到公车站，他要座７１６号的公车，大明等了很久可是公车也还没来。	到公车站，他要坐７１６号的公车，大明等了很久可是公车也还没来。
朋友的同学竟然说，你是不是古意把我的钱包丢在其他地方？	朋友的同学竟然说，你是不是故意把我的钱包丢在其他地方？
他戴著眼镜跟袜子入睡了。	他戴著眼镜跟袜子入睡了。
如果你们不处理的那我们不会可汽啦！	如果你们不处理的那我们不会客气啦！
天华觉得这次的考试一点都不难，因为昨天晚上他很认陈学习。	天华觉得这次的考试一点都不难，因为昨天晚上他很认真学习。
吃葚么？我要吃宫保鸡丁。	吃什么？我要吃宫保鸡丁。
因为他十点二十分上课，所以他九点从他的家到时大去。	因为他十点二十分上课，所以他九点从他的家到师大去。
我觉得日本饭馆儿在师大路不错也方便，因为离学校很近，所以我觉得他家都能参加。	我觉得日本饭馆儿在师大路不错也方便，因为离学校很近，所以我觉得大家都能参加。
最近上课好吗？公课会不会很难？	最近上课好吗？功课会不会很难？
最近我的弟弟也是被公司宣布「无薪假」了。	最近我的弟弟也是被公司宣布「无薪假」了。
你觉得岑么样？你能参加马？要是你能参加请你打电话给我。	你觉得怎么样？你能参加吗？要是你能参加请你打电话给我。
可是在学校的时候，老师会公平的对待每个小学生，如果错就要罚，怪的就会奖。	可是在学校的时候，老师会公平的对待每个小学生，如果错就要罚，乖的就会奖。
现在你的身体情形怎么杨？我希望你的身体变快好。	现在你的身体情形怎么样？我希望你的身体变快好。
昨天对她没来说是一个很特别的日子，台湾和美国棒球比赛最后的一天。	昨天对她们来说是一个很特别的日子，台湾和美国棒球比赛最后的一天。
朋友之间的关系偶尔发生误会的情况也是难免的，可是这不一定是不好的。	朋友之间的关系偶尔发生误会的情况也是难免的，可是这不一定是不好的。
这样的传统不但使女人的压力渐少，而且她们的休闲时间也增加。	这样的传统不但使女人的压力减少，而且她们的休闲时间也增加。
我愿意厕所要干净，因为人们容易记得很丑的地方。	我愿意厕所要干净，因为人们容易记得很丑的地方。
他放上他的婉，一辆汽车停了。	他放上他的腕，一辆汽车停了。
我今天写这封信给你也希望妳为你自己的健康早想一下、不要太看前面的利金望了自己跟大的建康。	我今天写这封信给你也希望妳为你自己的健康著想一下、不要太看前面的利金忘了自己更大的健康。
他还说我还年经，还没吃过很多苦，所以一碰到困难的事情就想放弃，就难过。我有现在都是由爸爸的鼓励。	他还说我还年经，还没吃过很多苦，所以一碰到困难的事情就想放弃，就难过。我有现在都是有爸爸的鼓励。
请不要太难过你朋有这么有反应也是理所当然的嘛。	请不要太难过你朋友这么有反应也是理所当然的嘛。
如果您认为我们的建有道理的话，倾斜给我一封答信，豁达一通电话给我。	如果您认为我们的建有道理的话，请写给我一封答信，或打一通电话给我。
同时我们也可以发挥爱心好好地照顾它们，给于它们温暖的生活。	同时我们也可以发挥爱心好好地照顾它们，给予它们温暖的生活。
还好她知道了这件事情所以来的及教导小孩，从那开始他不再玩电动、读书也很认真，显然有好的成绩。	还好她知道了这件事情所以来得及教导小孩，从那开始他不再玩电动、读书也很认真，显然有好的成绩。
这个先想再请少年不更普便。	这个现象在青少年不更普遍。
再这情形下，我们也希望您可以推出办法解决这问题，让我们这些住在工厂附近的人可以住在好的环境。	在这情形下，我们也希望您可以推出办法解决这问题，让我们这些住在工厂附近的人可以住在好的环境。
到了他的教室她就坐在最前面的异子灯塔的老师近来。	到了他的教室她就坐在最前面的椅子等他的老师进来。
就是说小朋友不认真，还是上课的内容已造过朋友的能力。	就是说小朋友不认真，还是上课的内容已超过朋友的能力。
被别人冤枉是很无奈的，可是已经当场澄清就算了巴。	被别人冤枉是很无奈的，可是已经当场澄清就算了吧。
我希望你近快处理这两件事情，让大家有安心的生活。	我希望你尽快处理这两件事情，让大家有安心的生活。
听说，妳的工课愈来愈重，但我相心妳会一定完成。	听说，妳的功课愈来愈重，但我相信妳会一定完成。
问题是网路游戏的内容含有太多的血性和色情。	问题是网路游戏的内容含有太多的血腥和色情。
我要再三强调，我非常的反对网路交友。	我要再三强调，我非常地反对网路交友。
他看我来，就问我为什么只到。	他看我来，就问我为什么迟到。
不上课的时候，我常常跟朋友去玩玩，看一看在台北好看的地方，晚上我就看书跟学子。	不上课的时候，我常常跟朋友去玩玩，看一看在台北好看的地方，晚上我就看书跟学字。
那一天我们安慰自己说朋友等以下就到了，但过了二十分钟他还没到，我立即给他打电话。	那一天我们安慰自己说朋友等一下就到了，但过了二十分钟他还没到，我立即给他打电话。
由于昨天家里比较热，所以我们打开窗户，怎么可能予想，外面臭得要命。	由于昨天家里比较热，所以我们打开窗户，怎么可能预想，外面臭得要命。
发生这些问题之前大家都知道学校的每个教室里装摄影机，坏人会放弃进去贵校，所以我称赞您的安排，因为您的方法是在防犯方面很有效的。	发生这些问题之前大家都知道学校的每个教室里装摄影机，坏人会放弃进去贵校，所以我称赞您的安排，因为您的方法是在防范方面很有效的。
他们一起很兴奋得聊聊天，都不关心老师说的话。	他们一起很兴奋地聊聊天，都不关心老师说的话。
优秀学生读钱多的系，可是常常不是他们所爱的科目，这就照成问题。	优秀学生读钱多的系，可是常常不是他们所爱的科目，这就照成问题。
应为我们公司最重要的客服会来台湾、所以我们要一起出去观光。	因为我们公司最重要的客户会来台湾、所以我们要一起出去观光。
您最至少好友领两天的薪水，大康现在努力找新的工作。不然您也要像他吗？	您最至少还有领两天的薪水，大康现在努力找新的工作。不然您也要像他吗？
请你考利以下或打我一个电话。	请你考虑一下或打我一个电话。
我在台湾常常去百货公司找雨鞋，可是我没看到那么票凉。	我在台湾常常去百货公司找雨鞋，可是我没看到那么漂亮。
她有花生过敏阿！她昨天快差一点死掉了！	她有花生过敏啊！她昨天快差一点死掉了！
如扩你有什么问题给我打电话。	如果你有什么问题给我打电话。
我是王天华，代表这区的民众来给您写一封信，关于您的工厂所造成的实像。	我是王天华，代表这区的民众来给您写一封信，关于您的工厂所造成的事项。
这样以来她们可以先拿到比较高的学位或甚至还累计机年工作的经验。	这样一来她们可以先拿到比较高的学位或甚至还累积几年工作的经验。
因为我好想证明自己，所以拼命去找很大的交易机会，结果检了合同后，才发现自己被骗，总价值和痛快到新台币五亿元。	因为我好想证明自己，所以拼命去找很大的交易机会，结果签了合同后，才发现自己被骗，总价值合同快到新台币五亿元。
你的生体现在怎么了？还好吗？	你的身体现在怎么了？还好吗？
在家里开了电脑练了学校网站就可以一边作事一边看看他们的宝贝上课的状况，孩子回来就不要问他今天上课态度怎样或有没有举手发表等等。	在家里开了电脑连了学校网站就可以一边做事一边看看他们的宝贝上课的状况，孩子回来就不要问他今天上课态度怎样或有没有举手发表等等。
要是你找不到你家店请你打电话给我。	要是你找不到那家店请你打电话给我。
从收到你打来的电话时，让我不断的思想。	从收到你打来的电话时，让我不断地思想。
我人生的目的在此，把我累绩到的经验与人家分享。	我人生的目的在此，把我累积到的经验与人家分享。
我从日本会把一个礼物买从给你。	我从日本会把一个礼物买送给你。
他们看很有处的电影，因为大看著看著笑起来了。	他们看很有趣的电影，因为他看著看著笑起来了。
我在师范大学念书，播爱大楼５０２教室。	我在师范大学念书，博爱大楼５０２教室。
总得来说，正规教育和游戏探索世界是缺一不可的。家长应该让孩子自由的摸索这个世界并适时的给予指导和协助。	总得来说，正规教育和游戏探索世界是缺一不可的。家长应该让孩子自由的摸索这个世界并适时的给予指导和协助。
我们很盼望你们工厂不要为了要赚钱牺牲了你们工厂的好名义与破毁了和我们人民们的好关系。	我们很盼望你们工厂不要为了要赚钱牺牲了你们工厂的好名义与破坏了和我们人民们的好关系。
到了一后他就走路，可是他要一个问题他不知道到学校怎么去。	到了以后他就走路，可是他有一个问题他不知道到学校怎么去。
在世界上的交流合作也是越来越需要得，网路出现已经改变世界的面貌。	在世界上的交流合作也是越来越需要的，网路出现已经改变世界的面貌。
你能从台配种战火车到淡水坐火车。	你能从台北总站火车到淡水坐火车。
如果透过摄影机发生他们的坏事，老师可以把录音给小孩罚。	如果透过摄影机发生他们的坏事，老师可以把录影给小孩罚。
所以每天上课艾伦都高高兴兴得学中文。	所以每天上课艾伦都高高兴兴地学中文。
有时候老师人不在教室里也可以看到孩子有没有在做功课，所以我觉得这作法对学校好。	有时候老师人不在教室里也可以看到孩子有没有在做功课，所以我觉得这做法对学校好。
有的时候如果下班时天气好的话，用走路回家。一边运动，一边绳钱，也可以说帮助环报换境。	有的时候如果下班时天气好的话，用走路回家。一边运动，一边省钱，也可以说帮助环保环境。
上课时间十七点四十分，八点我才上车去我迟到了，怎么办？	上课时间是七点四十分，八点我才上车去我迟到了，怎么办？
你可以住在我的家，你可以认识我的家又看我的够猫。	你可以住在我的家，你可以认识我的家又看我的狗猫。
多少青少年沉沦在网路的手里，身边的朋友多少位因为滥用网路送上了自己的前途，最后在人群中迷茫！	多少青少年沉沦在网路的手里，身边的朋友多少位因为滥用网路送上了自己的前途，最后在人群中迷茫！
我妈就打电话给那位阿姨叫他过来拿东西或上办时我妈带给她。	我妈就打电话给那位阿姨叫她过来拿东西或上班时我妈带给她。
当然经济发展也是一件很重要的事情，但是我认为我们需要由远见来看穿情况。	当然经济发展也是一件很重要的事情，但是我认为我们需要有远见来看穿情况。
另外的好处就是有时候教室哩，是因为没有老师在教室里而有些学生被他们的同学们迫害。	另外的好处就是有时候教室里，是因为没有老师在教室里而有些学生被他们的同学们迫害。
为什么只有女人结婚之后需要离开工司。我觉得结婚之后也可以继续去上班。	为什么只有女人结婚之后需要离开公司。我觉得结婚之后也可以继续去上班。
将工厂的排废系统调整降低工厂的臭味，并加强工厂的隔音减少噪音。或其他的方法使得工厂附近的住宅邻居能获得良好的生活环竟。	将工厂的排废系统调整降低工厂的臭味，并加强工厂的隔音减少噪音。或其他的方法使得工厂附近的住宅邻居能获得良好的生活环境。
他来我家的时，我还没有准备好，所以我先请他在客厅座一下看电视。	他来我家的时，我还没有准备好，所以我先请他在客厅坐一下看电视。
虽然我觉得有点辛苦，可使没有迟到过开始上班的时间。我的责任感不准我睡过头了。	虽然我觉得有点辛苦，可是没有迟到过开始上班的时间。我的责任感不准我睡过头了。
经过这件事不是你也长大了不少，对码？	经过这件事不是你也长大了不少，对吗？
以上的情况，情多多指教。	以上的情况，请多多指教。
应为阿根廷从一九九八年开始有经济的问题所以现在的情形是更严重的。	因为阿根廷从一九九八年开始有经济的问题所以现在的情形是更严重的。
妳上课很忙绿，我知道，我也忙著写论。	妳上课很忙碌，我知道，我也忙著写论。
电脑真的有很多应用，而且现在网路这么发展我们就可以做很多事情，比如视上网看报，找资讯，玩游戏，跟人家连络等等。	电脑真的有很多应用，而且现在网路这么发展我们就可以做很多事情，比如是上网看报，找资讯，玩游戏，跟人家连络等等。
后来老是进去，她一碰到老师就笑起来了。	后来老师进去，她一碰到老师就笑起来了。
在美国，大学生上班是很正常的事情。因为美国的大学制度让祖恶声选课比较开饭。	在美国，大学生上班是很正常的事情。因为美国的大学制度让祖恶生选课比较开放。
他不知道他在那一站要下车。	他不知道他在哪一站要下车。
在计程车也有一为美国朋友，她更不爽因为她在台北还工作。	在计程车也有一位美国朋友，她更不爽因为她在台北还工作。
小文、小明和小华在考。	小文、小明和小华在烤。
世界上最有名的德国蔡就是猪脚跟各种各样的香肠。	世界上最有名的德国菜就是猪脚跟各种各样的香肠。
如果李厂长不处理的话，请麻烦你办你们的工厂，记得在这土上不是自由你的。	如果李厂长不处理的话，请麻烦你搬你们的工厂，记得在这土上不是只有你的。
我觉得环境保护最中要。	我觉得环境保护最重要。
若本学校的网站只限给家长使用，这作法我很支持。	若本学校的网站只限给家长使用，这做法我很支持。
工厂内重新庄还墙壁成为隔音的效果。	工厂内重新装潢墙壁成为隔音的效果。
他们只能有两个选择：接受降新或自动离职。	他们只能有两个选择：接受降薪或自动离职。
道理其实非常的简单，所谓正常的人有正常的朋友网，不太需要上网交友。	道理其实非常地简单，所谓正常的人有正常的朋友网，不太需要上网交友。
其中除了从事关与电子方面的人员以外，最常使用网路的阶层应该是青少年。	其中除了从事关于电子方面的人员以外，最常使用网路的阶层应该是青少年。
在日本，大学生打工的情况很不偏。	在日本，大学生打工的情况很普遍。
今天早上我要找您可是您不在，所以我学给您在一张子。	今天早上我要找您可是您不在，所以我写给您在一张纸。
说不了几句话，钟就下起雨来了，他们急著找别的地方。	说不了几句话，终究下起雨来了，他们急著找别的地方。
根据人生的自然来讲，每个人都爱自己的家人，尤其是「儿子与妈妈的关奚」，大家都会知道他们的爱是无法计算的。	根据人生的自然来讲，每个人都爱自己的家人，尤其是「儿子与妈妈的关系」，大家都会知道他们的爱是无法计算的。
打工虽然可辛苦，还是值得做。	打工虽然很辛苦，还是值得做。
因此，我支持父母先制孩子们上网的时间，这样孩可以学到网路是如何拉近人与人在时空上的距离。	因此，我支持父母限制孩子们上网的时间，这样孩可以学到网路是如何拉近人与人在时空上的距离。
所以你好好得想要怎么做，如果要我帮甚么忙随时都可以告诉我。	所以你好好地想要怎么做，如果要我帮甚么忙随时都可以告诉我。
第二个介意如没办法的话，您们不能办到别的地方，您们可以做一些事情不要有臭臭的味道、也不会那么吵。	第二个建议如没办法的话，您们不能搬到别的地方，您们可以做一些事情不要有臭臭的味道、也不会那么吵。
最后，父亲将他送去了一个偏远地区，哪里没有电脑，希望他可以重新生活。	最后，父亲将他送去了一个偏远地区，那里没有电脑，希望他可以重新生活。
由于青少年年级尚轻，无法克制自己的行为，所以身为家长的父母亲应该担任克制的这个角色。	由于青少年年纪尚轻，无法克制自己的行为，所以身为家长的父母亲应该担任克制的这个角色。
我认为这是相当合理的情况，不仅不景气，主要的是打工对自己的将来也会更直得的经验。	我认为这是相当合理的情况，不仅不景气，主要的是打工对自己的将来也会更值得的经验。
到教室，我老师在教书，她对我很生气，我想怎的不好意思。	到教室，我老师在教书，她对我很生气，我想真的不好意思。
您可以想像我的惊讶，每天那么注意家人的事物安全我们居然还可以那么容易的中毒。	您可以想像我的惊讶，每天那么注意家人的食物安全我们居然还可以那么容易地中毒。
欸？为是么这么坏的情况？	欸？为什么这么坏的情况？
可是小孩也喜欢有自然的空间，我觉得「教室里装摄影机」是太夸张而太浪费了。	可是小孩也喜欢有自然的空间，我觉得「教室里装摄影机」是太夸张和太浪费了。
对不起，我不能参加你开的庆祝会，因为我有事情。但是我一定送给你一把很大的化。	对不起，我不能参加你开的庆祝会，因为我有事情。但是我一定送给你一把很大的花。
那天王先生馔衣服很好看，还有带蓝色的帽子。	那天王先生穿衣服很好看，还有带蓝色的帽子。
清流你的名子好让我谢谢您。	请留你的名字好让我谢谢您。
所以自己本身要做好时间管理，不能因为网路而让生活作息影像到正常生活，这样对身体也会造成重大的影响。	所以自己本身要做好时间管理，不能因为网路而让生活作息影响到正常生活，这样对身体也会造成重大的影响。
我就要参家你的会，可是那个天我跟我的妈妈和爸爸要去美因看见我的弟弟。	我就要参加你的会，可是那个天我跟我的妈妈和爸爸要去美国看见我的弟弟。
然后他的朋友进来大民的房间。	然后他的朋友进来大明的房间。
首先，我要说明他为什么不算商品。尽管却有人买卖牠，我想那种行为是不对的。	首先，我要说明牠为什么不算商品。尽管却有人买卖牠，我想那种行为是不对的。
我们的孩子和父母都因为噪音太大而睡不著，在村里大大小小都因臭味而生病了，有得病很严重。	我们的孩子和父母都因为噪音太大而睡不著，在村里大大小小都因臭味而生病了，有的病很严重。
但是在工厂我附近哪边，每天都排出怎么味道很臭跟很多噪音，有影响大家的建康和我们的生活。	但是在工厂我附近那边，每天都排出什么味道很臭跟很多噪音，有影响大家的健康和我们的生活。
我不认为打电脑打的久比较厉害，或是懂得多，重要的是内容。	我不认为打电脑打得久比较厉害，或是懂得多，重要的是内容。
我觉得大学生打工赚钱减少父母的负担是个好时。	我觉得大学生打工赚钱减少父母的负担是个好事。
我认为，一个人是透过人际关系学习人生的深澳意义，这个角色是高薪或金钱没办法做到的。	我认为，一个人是透过人际关系学习人生的深奥意义，这个角色是高薪或金钱没办法做到的。
我想，每个人都有自己的梦想一定要有勇感去实现它。	我想，每个人都有自己的梦想一定要有勇敢去实现它。
我们坐车４５分就到，我们开ＢＢＱ，我们都很快，我们玩的横高兴。	我们坐车４５分就到，我们开ＢＢＱ，我们都很快，我们玩得很高兴。
我也受到了经济的影响：我们是要上班但是薪水便少了。	我也受到了经济的影响：我们是要上班但是薪水变少了。
我会到晚上十点才回家，所以没时间看电影，请你寮解我，谢谢。	我会到晚上十点才回家，所以没时间看电影，请你了解我，谢谢。
刚开始我沉迷于「即时通」，每天和朋友在线上可以聊上数小时，聊一些有的没的，时间随著网路流逝的非常快，完全没有时间和精神可以应用在课业上。	刚开始我沉迷于「即时通」，每天和朋友在线上可以聊上数小时，聊一些有的没的，时间随著网路流逝地非常快，完全没有时间和精神可以应用在课业上。
妈妈教孩子画画，看化就让孩子长大以后有温柔温柔的个性，没有动手打人的态度。	妈妈教孩子画画，看画就让孩子长大以后有温柔温柔的个性，没有动手打人的态度。
我下了课以后，就根她坐公共汽车一起回家。	我下了课以后，就跟她坐公共汽车一起回家。
还记得有一次，在你的生日晚上，我们把你仍到水池吗？	还记得有一次，在你的生日晚上，我们把你扔到水池吗？
他愿赖天气太热，所以在路旁边停了。	他原来天气太热，所以在路旁边停了。
但是那时后我真的不知道那一方面的事比较适合我，比较喜欢。	但是那时后我真的不知道哪一方面的事比较适合我，比较喜欢。
我觉得这些人也在第二个象片儿，也在第三个象片儿。这个男人也在第一个象片儿。这两人是朋友。	我觉得这些人也在第二个相片儿，也在第三个相片儿。这个男人也在第一个象片儿。这两人是朋友。
在那个地方我打算走差不多三个小时走路，我开是走路的时候我觉得很强。	在那个地方我打算走差不多三个小时走路，我开始走路的时候我觉得很强。
反正，随著时间的流逝，春秋转换事情也被遗忘的快无足迹，却会带来丰盛的人生经历。	反正，随著时间的流逝，春秋转换事情也被遗忘得快无足迹，却会带来丰盛的人生经历。
但人对生活续求越来越高也想要享受安全及舒服，房车以竟成为人的生活必要不可却少。	但人对生活需求越来越高也想要享受安全及舒服，房车已经成为人的生活必要不可缺少。
你说的是对，跟那些失业的人比起来你也算是辛运的。	你说的是对，跟那些失业的人比起来你也算是幸运的。
每个礼拜一早上七点我都有课，可是上个周末，我朋友从美国来我家。	每个礼拜一早上七点我都有课，可是上个周末，我朋友从美国来我家。
虽然他们是小孩，需要成人的照顾，但他们也有人劝，我们应该尊重他们。	虽然他们是小孩，需要成人的照顾，但他们也有人权，我们应该尊重他们。
他们约在已前他们去过的那家餐厅。	他们约在以前他们去过的那家餐厅。
虽然学校里的事很多很忙但我妈妈一样的把我们照顾得很好。	虽然学校里的事很多很忙但我妈妈一样地把我们照顾得很好。
小孩子开始他们的正规教育的间题在有个地方解决不同。	小孩子开始他们的正规教育的问题在有的地方解决不同。
免费电影元电影播放或是网路拍卖等等网路就有很多资讯，很多东西容易让你上瘾像线上游戏、社群网站、免费电影元电影播放或是网路拍卖等等，很容易让你一直一直没办法做其他事情，没办法好好的念书等等。	免费电影院电影播放或是网路拍卖等等网路就有很多资讯，很多东西容易让你上瘾像线上游戏、社群网站、免费电影元电影播放或是网路拍卖等等，很容易让你一直一直没办法做其他事情，没办法好好的念书等等。
俗话说：鱼和熊张不可嗛得。我一定要选择的话，我支持环景保呼为甚么呢？我大概想两个方面。	俗话说：鱼和熊掌不可兼得。我一定要选择的话，我支持环境保护为甚么呢？我大概想两个方面。
我推建大学生一边读书一边上班这种状况，因为我觉得有工作的学生的想法比没有工作的学生想法成熟。	我推荐大学生一边读书一边上班这种状况，因为我觉得有工作的学生的想法比没有工作的学生想法成熟。
老师跟他说，只有妳一个人没有来考试，你就等下个学期吧！	老师跟他说，只有你一个人没有来考试，你就等下个学期吧！
我们民众相信贵公司，拜托贵公司，尽快时间内帮我们处理这件事。	我们民众相信贵公司，拜托贵公司，尽快时间内帮我们处理这件事。
我以前也有遇过跟你类似这种情况，哪时候我才念大学第一年。	我以前也有遇过跟你类似这种情况，那时候我才念大学第一年。
在络上我碰到我的好朋友，他知道我打算买牛肉，他送我一包牛肉。	在路上我碰到我的好朋友，他知道我打算买牛肉，他送我一包牛肉。
我已经来台湾气个月了。	我已经来台湾七个月了。
您要跟我多联络或者您要想要看我的家得医院报告，请您通知我，我就马上寄到卫生局办公室。	您要跟我多联络或者您要想要看我的家的医院报告，请您通知我，我就马上寄到卫生局办公室。
如果宠物公司会流行的话，他们会担心养宠物可能带来相反的校果。	如果宠物公司会流行的话，他们会担心养宠物可能带来相反的效果。
对我来说，这是很有意义得一件事。	对我来说，这是很有意义的一件事。
请注意！周末也是。周末的时候，很多人要在家休息。	请注意！周末也是。周末的时候，很多人要在家休息。
昨天再图书馆外面我掉了一本。	昨天在图书馆外面我掉了一本。
如果以台湾为例，保护环境调查研究表明，台湾人对于保护环境的意识很高。次缘故也是经济发展的结果。	如果以台湾为例，保护环境调查研究表明，台湾人对于保护环境的意识很高。此缘故也是经济发展的结果。
我提你们很高兴喔。	我替你们很高兴喔。
俗话说「为人不做亏心事，半夜鬼敲门也不警」。	俗话说「为人不做亏心事，半夜鬼敲门也不惊」。
我受到了一封邀请卡，我想去你们的婚礼祝福你们，不过因为我刚好你们婚礼那天我要考试。	我收到了一封邀请卡，我想去你们的婚礼祝福你们，不过因为我刚好你们婚礼那天我要考试。
总结来说，适当的使用网路将会为我们带来不少的方便，相反的，它将会影响我们的正常作息，甚至影响我们的身心灵。	总结来说，适当地使用网路将会为我们带来不少的方便，相反的，它将会影响我们的正常作息，甚至影响我们的身心灵。
老是较书。	老师教书。
最好，还是我们双方共同举办一个座谈，让双方代表可以「大开天窗说亮话」。	最好，还是我们双方共同举办一个座谈，让双方代表可以「打开天窗说亮话」。
如果你方面的话，我会三十分前接你。	如果你方便的话，我会三十分前接你。
我受到你来信，非常高兴。	我收到你来信，非常高兴。
网路对我们影响非浅，它不但让我们日常生活变得更方便，也为我们生活增添了不少的色彩。	网路对我们影响匪浅，它不但让我们日常生活变得更方便，也为我们生活增添了不少的色彩。
你设么失火有空？我要请你我家吃韩国的包子。	你什么时候有空？我要请你我家吃韩国的包子。
其实如果工作不会影响到读书的方面和不会超过学生的能力，应该可以保留让学生一边功作一边读书的。	其实如果工作不会影响到读书的方面和不会超过学生的能力，应该可以保留让学生一边工作一边读书的。
各国都市化的势趋很强烈，炫丽多采的大城市是国家繁荣的象征。	各国都市化的势趋很强烈，炫丽多彩的大城市是国家繁荣的象征。
我认为你还是不要太难过，好好的用这个机会来培养自己的兴趣，并且做自己有兴趣的事情。	我认为你还是不要太难过，好好得用这个机会来培养自己的兴趣，并且做自己有兴趣的事情。
他们要搭２９７号共车到山上旅行。	他们要搭２９７号公车到山上旅行。
最近工厂的噪音和臭味对著附近的邻居有很大的影响。	最近工厂的噪音和臭味对这附近的邻居有很大的影响。
虽然这么困难但是我认为我们要乐观一点，别想这么悲观麻！	虽然这么困难但是我认为我们要乐观一点，别想这么悲观嘛！
所以我请你们好好地管理全部得农场，还有可以被罚钱。	所以我请你们好好地管理全部的农场，还有可以被罚钱。
有一次在台湾我看到一份报仔，两夫妻因为迷上网玩电动玩具，把一个小朋友活活饿死！	有一次在台湾我看到一份报纸，两夫妻因为迷上网玩电动玩具，把一个小朋友活活饿死！
等几天，在跟他们见面，打电话。	等几天，再跟他们见面，打电话。
我作天学中文到晚上十点。	我昨天学中文到晚上十点。
因为我们看电影看到很晚，女生一个人回家不太好，所以我去送林美妹回家我才回家。	因为我们看电影看到很晚，女生一个人回家不太好，所以我去送林美美回家我才回家。
每个人带不一样的东西，也常不一样的衣服。	每个人带不一样的东西，也穿不一样的衣服。
阿伟在床上好好得睡，突然感觉到太阳很大！他救起来看时钟，怎么办时间已经八点二十分了！	阿伟在床上好好得睡，突然感觉到太阳很大！他就起来看时钟，怎么办时间已经八点二十分了！
九号是我的弟弟生日，所以我想要请你们一起来我的家完、吃饭、也吃党奥。	九号是我的弟弟生日，所以我想要请你们一起来我的家玩、吃饭、也吃蛋糕。
下个礼拜我跟隔壁们有开会，我要请你们来挑聊这个很重要的问题。	下个礼拜我跟隔壁们有开会，我要请你们来讨论这个很重要的问题。
以上是我们工厂工业区民主对您们工厂的反应。	以上是我们工厂工业区邻居对您们工厂的反映。
现在我从火车站要去学校学中文，可是我不知道，学校在哪理。	现在我从火车站要去学校学中文，可是我不知道，学校在哪里。
他们给我妈资询日本哪里好玩，天气怎么样，他们的饮食文化，风俗习惯如何．．．等等。	他们给我妈咨询日本哪里好玩，天气怎么样，他们的饮食文化，风俗习惯如何．．．等等。
若贵公司仍然不愿意处理上述问题，居民将成立环境自救委由会，将现有搜集到的污染资料，转交给司法单位处理。	若贵公司仍然不愿意处理上述问题，居民将成立环境自救委员会，将现有搜集到的污染资料，转交给司法单位处理。
她告诉他学校的路道，怎嚜去比较快到学校去。	她告诉他学校的路道，怎么去比较快到学校去。
为了太噪，下午孩子不能好好的休息、学习、做作业、什么的，然后晚上我们不可以睡觉。	为了太吵，下午孩子不能好好的休息、学习、做作业、什么的，然后晚上我们不可以睡觉。
我的国家青少年上网都葱满兴趣的，对他们来说上网又可以学到了很多东西，而且在网路上可以找到很多好的消息。	我的国家青少年上网都充满兴趣的，对他们来说上网又可以学到了很多东西，而且在网路上可以找到很多好的消息。
如上我已经写的很经楚、如果李厂长部快速处理或故意不处理的话，我们这里的邻居就无法再忍受了、到时候不要说我们没提醒你、我们会告你、让法律解决这问题了。	如上我已经写的很清楚、如果李厂长不快速处理或故意不处理的话，我们这里的邻居就无法再忍受了、到时候不要说我们没提醒你、我们会告你、让法律解决这问题了。
虽然我很幸运的还可以留下来继续的上班，但是却必须过著「三天捕鱼，两天晒网」的日子。	虽然我很幸运地还可以留下来继续的上班，但是却必须过著「三天捕鱼，两天晒网」的日子。
而且她不止对做贸易很专业，她还常常去国外跟各种各样的公司做生意。	而且她不只对做贸易很专业，她还常常去国外跟各种各样的公司做生意。
我想到我们可以去逛逛，我想我们可以去台湾然后专机往新加波。	我想到我们可以去逛逛，我想我们可以去台湾然后转机往新加坡。
「教室里该不该装摄影机」这个议题真的很难决定哪一方面是对的，因为除了见人见意的问题以外，这件事情的两个方面都有它们自己的好处，真的是「青菜、萝卜、各有所味」。	「教室里该不该装摄影机」这个议题真的很难决定哪一方面是对的，因为除了见仁见智的问题以外，这件事情的两个方面都有它们自己的好处，真的是「青菜、萝卜、各有所味」。
周末时要依靠法律的规定（就是说不能有任何会打扰附近的噪音）。	周末时要依照法律的规定（就是说不能有任何会打扰附近的噪音）。
我要选就是女人结婚生子以后应该继续工作当个职业妇女，不只靠者先生。	我要选就是女人结婚生子以后应该继续工作当个职业妇女，不只靠著先生。
过了一个小时两个小时他的朋友都回家了，但是阿伟还在哪里玩一玩。	过了一个小时两个小时他的朋友都回家了，但是阿伟还在那里玩一玩。
阿，对了！我回来一定送给你一个礼物。	啊，对了！我回来一定送给你一个礼物。
我的公司有两名员工也被裁员了，因此他们打算要一起创业当老板，还邀请我来参加开募呢。	我的公司有两名员工也被裁员了，因此他们打算要一起创业当老板，还邀请我来参加开幕呢。
我这个月有考试，所以我要赶快念书没有时间跟你去除去完。	我这个月有考试，所以我要赶快念书没有时间跟你去出去玩。
在捷克好像没有人文这样的问题，几乎每个大学生甚至高中生都有打工的经验。	在捷克好像没有人问这样的问题，几乎每个大学生甚至高中生都有打工的经验。
来我们看这节目很不做，我很喜欢。	来我们看这节目很不错，我很喜欢。
因为我不能，所以我准备小礼物，解我的朋友送给你。希望你喜欢。	因为我不能，所以我准备小礼物，请我的朋友送给你。希望你喜欢。
还有两个同学可能气人别的同学可是老师不会停他们因为她觉得这件事不重要，那这件事不好。	还有两个同学可能欺凌别的同学可是老师不会停他们因为她觉得这件事不重要，那这件事不好。
她告诉爱文：如果他在晚上喝酒他的生体一定不太好。	她告诉爱文：如果他在晚上喝酒他的身体一定不太好。
我想因为太多想要养狗的人他们想要就养没有考虑到养狗的麻烦，所以发见没办法养狗就悼在河边。	我想因为太多想要养狗的人他们想要就养没有考虑到养狗的麻烦，所以发现没办法养狗就掉在河边。
我觉得最近的小孩子由于只一个老师没帮法控制，而且很多孩子的父母在家里教养地不好，他们都把教养的责任给学校。	我觉得最近的小孩子由于只一个老师没办法控制，而且很多孩子的父母在家里教养地不好，他们都把教养的责任给学校。
美国过学生的经验虽冉有选择上的自由，我们仔细的刊的话，学的情形也夺取美国年轻人力德竞争力。	美国过学生的经验虽然有选择上的自由，我们仔细地看的话，学的情形也夺取美国年轻人力的竞争力。
再加上，煤田工厂发出来的声音真让人受不了，要是人民休息的话也没有安静的环境，真是让人难受。	再加上，每天工厂发出来的声音真让人受不了，要是人民休息的话也没有安静的环境，真是让人难受。
现在跟你们谈网路交友自己的经验，因为我在这个方面过了不少的型况。	现在跟你们谈网路交友自己的经验，因为我在这个方面过了不少的情况。
过十分钟，天气下雨，我们跑的很快。	过十分钟，天气下雨，我们跑得很快。
现在他们没办法付房租所以他们回到爸爸妈妈的家，所以他们的房东也没收到房租的钱就不能贿银行的款！	现在他们没办法付房租所以他们回到爸爸妈妈的家，所以他们的房东也没收到房租的钱就不能汇银行的款！
那个时候我们只好慢慢得安慰鼓励他让他想得开，他想得开以后就改变自己的想法了。	那个时候我们只好慢慢地安慰鼓励他让他想得开，他想得开以后就改变自己的想法了。
在夜店很热闹，有很多辣妹在跳舞，还可以喝酒和啤酒，跳无，跟啦妹聊一聊。	在夜店很热闹，有很多辣妹在跳舞，还可以喝酒和啤酒，跳舞，跟辣妹聊一聊。
我们有很多事情先要钱、对不对？请您告诉我您要负多少钱？我提案别的事。	我们有很多事情先要钱、对不对？请您告诉我您要付多少钱？我提案别的事。
空气也不好，每次出门，我们一定要带口袋。	空气也不好，每次出门，我们一定要戴口袋。
当下的我，当然非常的生气，而且感到十分的委曲。	当下的我，当然非常的生气，而且感到十分的委屈。
我们很希望您著一点处理好这件事情。如果有任何困难您也可以请我们榜首我们都很愿意，免得我们都有愉快的声、好好的工作。	我们很希望您早一点处理好这件事情。如果有任何困难您也可以请我们帮手我们都很愿意，免得我们都有愉快的生、好好的工作。
听到你们的公司也要实施「无薪徦」，我恨惊讶了。	听到你们的公司也要实施「无薪徦」，我很惊讶了。
我们谁都刚回家之后要休息一下，看看电视，跟家人聊天，安安静静的香果汁个小时。	我们谁都刚回家之后要休息一下，看看电视，跟家人聊天，安安静静的想过几个小时。
我们决定下个月一起去发山。	我们决定下个月一起去爬山。
理面的汽车有一个人，他说他可以开送给他会家。	里面的汽车有一个人，他说他可以开送给他回家。
天那！你的公司正在实施「无薪假」，而且那么多的假日。	天哪！你的公司正在实施「无薪假」，而且那么多的假日。
当时住宅区规划的时候贵工厂休场，没有人预测您会重新开场。	当时住宅区规划的时候贵工厂休厂，没有人预测您会重新开厂。
他到学校的时后，中文课已经开始。	他到学校的时候，中文课已经开始。
季厂长您好！	李厂长您好！
李大明去冰箱拿一些点心拿一些甜点跟两配啤酒。	李大明去冰箱拿一些点心拿一些甜点跟两瓶啤酒。
你们可以坐市大公车来到我们的家对面。	你们可以坐师大公车来到我们的家对面。
他喜欢穿蓝色的睡衣、戴著眼睛。	他喜欢穿蓝色的睡衣、戴著眼镜。
我觉得中文课跟公司一样中要，可是这是他们头一次跟欧洲做生意，所以我也要看一看，有什么学的。	我觉得中文课跟公司一样重要，可是这是他们头一次跟欧洲做生意，所以我也要看一看，有什么学的。
所以如果有摄影机录下在学校所有的活动，老师们已经按照合理的方法来教小孩可是还会发生意外的话，人家也不会在误会学校或是老师们做错。	所以如果有摄影机录下在学校所有的活动，老师们已经按照合理的方法来教小孩可是还会发生意外的话，人家也不会再误会学校或是老师们做错。
他如此做的不是应为他真正地怀疑妳。也不是因为妳看起来是个小偷，因为我保证妳不像。	他如此做的不是因为他真正地怀疑妳。也不是因为妳看起来是个小偷，因为我保证妳不像。
他方假的时候去爬山。	他放假的时候去爬山。
我非常同意这位私立小学的校长的看法因为我觉得如果他把这个机在教室里面然后把场地影片上拆学校的网站，所以父母随时会看他们的孩子在教室里在做什么。	我非常同意这位私立小学的校长的看法因为我觉得如果他把这个机在教室里面然后把场地影片上传学校的网站，所以父母随时会看他们的孩子在教室里在做什么。
那到底保护环境比建立公路尤甚么更多的利处呢？	那到底保护环境比建立公路有甚么更多的利处呢？
在每一个教室里装了摄影机，好让在家里的家长们能够连上学校的网站来观察牠们孩子在教室里的活动。	在每一个教室里装了摄影机，好让在家里的家长们能够连上学校的网站来观察他们孩子在教室里的活动。
家人给小孩子一部手机，因为安全，家人可以常连路跟他们的孩子。	家人给小孩子一部手机，因为安全，家人可以常连络跟他们的孩子。
在那边他一边喝酒一边跳舞，他们挑了不知道时间，所以夜里三点半才回家。	在那边他一边喝酒一边跳舞，他们跳了不知道时间，所以夜里三点半才回家。
苏嘉的时候我想回印尼，但是我没有时间。	暑假的时候我想回印尼，但是我没有时间。
那动行为会破坏租的人跟被出租的狗双方的心。所以我不想出租动物是好办法，也就是说我反对出租动物来赚钱。	那种行为会破坏租的人跟被出租的狗双方的心。所以我不想出租动物是好办法，也就是说我反对出租动物来赚钱。
我们跑来跑出，不知道要做神马。	我们跑来跑出，不知道要做什么。
今天早上在这个大搂里弄丢了我的书。	今天早上在这个大楼里弄丢了我的书。
可是如果人们太习惯再网路上跟其他人沟通的话，就有可能会忘记怎么真的和人讲话。	可是如果人们太习惯在网路上跟其他人沟通的话，就有可能会忘记怎么真的和人讲话。
但是到了中学，他们都开始大量的用电，而到了大学，他们都已经忘记了在小学时学的很多字。	但是到了中学，他们都开始大量地用电，而到了大学，他们都已经忘记了在小学时学的很多字。
你们的工人很多请告诉他们离开工厂的时候不要太噪。	你们的工人很多请告诉他们离开工厂的时候不要太吵。
难怪他的英文这么好！他们聊体一点就上课。	难怪他的英文这么好！他们聊天一点就上课。
你去一前，我可以给你钱。	你去以前，我可以给你钱。
重新庄还排水及排烟处理措施以免空气污染。	重新装潢排水及排烟处理措施以免空气污染。
大学生半工半读的现象，在泰国是一个很普遍得现象。	大学生半工半读的现象，在泰国是一个很普遍的现象。
我已经打给南澳朋友电话，踏青我们睡在他的家。	我已经打给南澳朋友电话，他请我们睡在他的家。
第三个介意是您们看一看甚么样的东西会有这种味道还是这种声音。	第三个建议是您们看一看甚么样的东西会有这种味道还是这种声音。
如果你可以在一个月内解解这个问题，与让我们的空气回溯以前的话，我们就会满意。	如果你可以在一个月内解决这个问题，与让我们的空气回溯以前的话，我们就会满意。
老师说：「好好美关系，明天你得来８点好不。」。	老师说：「好好没关系，明天你得来８点好不。」。
今天早上我在班公司找妳，可是妳还没来，所以我留一张纸告诉妳。	今天早上我在办公室找妳，可是妳还没来，所以我留一张纸告诉妳。
但是菊花对日本人而言，是丧礼食时摆列的花，因此教授一看就生气，而把他赶出去了。	但是菊花对日本人而言，是丧礼时时摆列的花，因此教授一看就生气，而把他赶出去了。
煤田您的工厂排出一量很大的臭味让这里的空气被污染，在这里的人整天都吸著这个臭味，真让身体不舒服，也有可能会发生疾病。	每天您的工厂排出大量很大的臭味让这里的空气被污染，在这里的人整天都吸著这个臭味，真让身体不舒服，也有可能会发生疾病。
如果没有打工经验没办法办段找哪一个行业等。	如果没有打工经验没办法判断找哪一个行业等。
我也知道你很难过也想找个办法何以发泄，而大声喊也是各办法。	我也知道你很难过也想找个办法可以发泄，而大声喊也是个办法。
二十四小时之后他终于到中正机场。	二十四小时之后她终于到中正机场。
对这种人而言，一后你再也不要理他了！　	对这种人而言，以后你再也不要理他了！　
所以我先去看医生，再去你的祝庆会。	所以我先去看医生，再去你的祝庆会。
他们觉得竟然不是你拿的，你就不介意给人家检察背包。	他们觉得竟然不是你拿的，你就不介意给人家检查背包。
庞大的噪音与及无法忍受的臭味不因时间的变迁而有减低。	庞大的噪音以及无法忍受的臭味不因时间的变迁而有减低。
这样父母只要在家打开电脑就可以掌握自己的子女在教室内的庄况，这样子女们也不敢回到家就向爸爸妈妈说谎了。	这样父母只要在家打开电脑就可以掌握自己的子女在教室内的状况，这样子女们也不敢回到家就向爸爸妈妈说谎了。
我不喜欢在学由装摄影机，因为对个人来讲没有自由。	我不喜欢在学有装摄影机，因为对个人来讲没有自由。
但我们很希望李厂长能处理这件事，可以开始做调查到底是什么原因产生嗓音和臭味。	但我们很希望李厂长能处理这件事，可以开始做调查到底是什么原因产生噪音和臭味。
虽然是私立学校，但是亦不应该以「非道德法」的手段进行教化。	虽然是私立学校，但是亦不应该以「非道德化」的手段进行教化。
他走了很久以后他觉得一点累，所以他现休息一下，再决定回家。	他走了很久以后他觉得一点累，所以他先休息一下，再决定回家。
西方文化的发启、传统的教育也渐渐的朝著西方多元化的教育看齐、自由的发挥、思考、研究．．．等。	西方文化的发起、传统的教育也渐渐的朝著西方多元化的教育看齐、自由的发挥、思考、研究．．．等。
关于教室里的摄影机，我非常支持这位校长的作法，我相信教室里装摄影机会给有关学校跟学生带来好几个优点。	关于教室里的摄影机，我非常支持这位校长的做法，我相信教室里装摄影机会给有关学校跟学生带来好几个优点。
我觉得狗也是一个生命，不可以像东西一样想要的时候买不需要就悼。	我觉得狗也是一个生命，不可以像东西一样想要的时候买不需要就掉。
我明天四点有空，你呢？想不想吃台湾采？	我明天四点有空，你呢？想不想吃台湾菜？
所以孩子长大以后妈妈应该做工作，别再家。	所以孩子长大以后妈妈应该做工作，别在家。
我没办法经营你的公司，为了你退休，改怎么处理后事。	我没办法经营你的公司，为了你退休，该怎么处理后事。
他们不高兴因为他们的衣服溪溪的。	他们不高兴因为他们的衣服湿湿的。
李台生根林小安一起开过去火车站。	李台生跟林小安一起开过去火车站。
相反的，他却造成青少年身心灵发展不良的现象，如沟通能力障碍、自闭症、近视等等。	相反地，他却造成青少年身心灵发展不良的现象，如沟通能力障碍、自闭症、近视等等。
我们因该鼓励青少年继续培养这些能力，因为限况已经不是如此。	我们应该鼓励青少年继续培养这些能力，因为现况已经不是如此。
我对台湾的文花很有兴趣，所以常常跟台湾的朋友一起出去。	我对台湾的文化很有兴趣，所以常常跟台湾的朋友一起出去。
我认为家庭教育跟学校教育要相结合，但结合这个辞有时被误解。	我认为家庭教育跟学校教育要相结合，但结合这个词有时被误解。
因为让您自己处理全部得问题比较好，希望我们会有机会跟您一起到论这个事情。	因为让您自己处理全部的问题比较好，希望我们会有机会跟您一起讨论这个事情。
我们生为上班族的还有孩子要照顾，每个人都想要给家庭一个很好的环境，可是因为您们最近在工厂的活动让我们都没办法安安钝钝的过生活。	我们身为上班族的还有孩子要照顾，每个人都想要给家庭一个很好的环境，可是因为您们最近在工厂的活动让我们都没办法安安顿顿的过生活。
他平常来一点早，可是作天他来了一点晚。	他平常来一点早，可是昨天他来了一点晚。
网路对我，好的事情是第一很容易找到资料，第二很容易连路别人，第三不关时间。	网路对我，好的事情是第一很容易找到资料，第二很容易连络别人，第三不关时间。
感觉很舒服的装黄也被人吸引。	感觉很舒服的装潢也被人吸引。
真麻烦你了。希望你们好好的跳无。	真麻烦你了。希望你们好好的跳舞。
明明只是单纯的玩了几个游戏，时间就莫名的流逝了。	明明只是单纯地玩了几个游戏，时间就莫名地流逝了。
隔天我一个人到超市去了，可使保安员不让我进入跟总经理讲话。	隔天我一个人到超市去了，可是保安员不让我进入跟总经理讲话。
往往在一刹那的冲动下会想不应该向的事儿、甚至于会讲出来不应该讲的话。	往往在一刹那的冲动下会想不应该想的事儿、甚至于会讲出来不应该讲的话。
我明天不能来上课因为有是请，要去新竹。	我明天不能来上课因为有事情，要去新竹。
他们看了一个很可爱的电影，一个小机一个人去火星。	他们看了一个很可爱的电影，一个小鸡一个人去火星。
我表妹的先生也失去了他的工作。因为这样房租也太高乐，而决定了去借宿他父亲的家。	我表妹的先生也失去了他的工作。因为这样房租也太高了，而决定了去借宿他父亲的家。
我来这边学中文，忍识台湾人的惜贯、文化。	我来这边学中文，认识台湾人的习惯、文化。
在台湾有的东四看起来奇怪，可是现在我不要说。	在台湾有的东西看起来奇怪，可是现在我不要说。
孩子去学校的时候，妈妈才工作，可以方心一点因为孩子有一些事可以照顾自己，如果孩子有问题的话就辅导她，跟他讲道理。	孩子去学校的时候，妈妈才工作，可以放心一点因为孩子有一些事可以照顾自己，如果孩子有问题的话就辅导她，跟他讲道理。
当然，倒地要让你决定。	当然，到底要让你决定。
因为人的生活很短如果可以一边读书一边工作就表示我们更走的快，更找得到自己喜欢的职业，更专门，更有经验。	因为人的生活很短如果可以一边读书一边工作就表示我们更走得快，更找得到自己喜欢的职业，更专门，更有经验。
后来，钱包终于找到了，原来在我的书包里。那时我真的很惭愧，为何要怀疑我的室友！	后来，钱包终于找到了，原来在我的书包里。那时我真的很惭愧，为何要怀疑我的室友！
先在由于网路的发达，人人都可以上网，还可以通过网路谈情说爱，年轻人对选伴择偶多元化，跟以前的社会完全不同。	现在由于网路的发达，人人都可以上网，还可以通过网路谈情说爱，年轻人对选伴择偶多元化，跟以前的社会完全不同。
像我跟朋友们，有的时候会觉得为是么那时候要上大学。	像我跟朋友们，有的时候会觉得为什么那时候要上大学。
打明的班已经上了二十分钟的课。	大明的班已经上了二十分钟的课。
但如果您不可做哪些方法您要给我们做家里的隔音设备。	但如果您不可做那些方法您要给我们做家里的隔音设备。
我了解你现在的情况，在经济率退的时候社会上的很多工作领域都会受到影响。	我了解你现在的情况，在经济衰退的时候社会上的很多工作领域都会受到影响。
我很高兴受到你们结婚的邀请单，你们到底决定结婚了！	我很高兴收到你们结婚的邀请单，你们到底决定结婚了！
因为疑惑我朋友的人小时候遇见过的不好的外国人令他心里面建立了对外国人的负面印象，好让他面对外国人时，不管那位外国人是甚么样的人，他都会用一样的看法来对待外国人。	因为疑惑我朋友的人小时候遇见过的不好的外国人令他心里面建立了对外国人的负面印象，好让他面对外国人时，不管那位外国人是甚么样的人，他都会用一样的看法来对待外国人。
应为最近天气渐渐冷了，所以我要穿外套。	因为最近天气渐渐冷了，所以我要穿外套。
我很西欢吃中国饭。	我很喜欢吃中国饭。
到了学校以后，进去搬上大卫马上坐著，因为有疑点背包也放在桌上。	到了学校以后，进去班上大卫马上坐著，因为有一点背包也放在桌上。
有录音机的化，也有其他的好处，例如，也许有一些学生们做坏事的时候，警察会知道谁做的。	有录音机的话，也有其他的好处，例如，也许有一些学生们做坏事的时候，警察会知道谁做的。
以前已经有了臭味和噪音，那时候我们还是没有怪你，应为我们知道工厂多多少少一定会有，可是想在我们真的没我们真的没有办法下去忍耐。	以前已经有了臭味和噪音，那时候我们还是没有怪你，因为我们知道工厂多多少少一定会有，可是想在我们真的没我们真的没有办法下去忍耐。
我在波兰学了亚洲文化还有管哩。	我在波兰学了亚洲文化还有管理。
长爱文对她很好，因为她们都是好朋友。	张爱文对她很好，因为她们都是好朋友。
例如说，使用电脑后每三十分钟要休息、在暗暗的地方不可以使用、绝对不可以影像到学校上课等等。	例如说，使用电脑后每三十分钟要休息、在暗暗的地方不可以使用、绝对不可以影响到学校上课等等。
很久没见到你，这也是一次机会让我们有个时间聊一聊，让你心情经松一点。	很久没见到你，这也是一次机会让我们有个时间聊一聊，让你心情轻松一点。
然而身在马来西亚的我，所看到的网络普及性不比台湾来的低，虽然网速比台湾来的慢，但是上网中心则是一家开的比一家快	然而身在马来西亚的我，所看到的网络普及性不比台湾来得低，虽然网速比台湾来得慢，但是上网中心则是一家开得比一家快
臭味对吴家餐厅也有不要的影响。	臭味对吴家餐厅也有不小的影响。
下个星期，我跟我朋唷打算去法国玩儿。	下个星期，我跟我朋友打算去法国玩儿。
后来我才想到一个好放法就是广拨我公司的产品在网路上。	后来我才想到一个好方法就是广播我公司的产品在网路上。
首先谢谢妳的信件！然后平安的回来了太好了！	首先谢谢妳的信件！然后平安地回来了太好了！
塔说那便是亏快的路。	他说那边是最快的路。
我很想参家你的舞会因为你的舞会总是很好玩。	我很想参加你的舞会因为你的舞会总是很好玩。
庆祝你的结昏，可是我有国外出差，所以我不能掺加。	庆祝你的结婚，可是我有国外出差，所以我不能参加。
我想问你明天清假，因为今天下课以后我发现我的车子被偷走了。	我想问你明天请假，因为今天下课以后我发现我的车子被偷走了。
王大华的孩子很饿所以他们买吃的东西，他们很高行。	王大华的孩子很饿所以他们买吃的东西，他们很高兴。
以我看都有利弊，里的就是：这样可以让家长方便地灌茶孩子学习情况，从这里可已有适合的方法教导他们而且也让父母比较安心。	以我看都有利弊，利的就是：这样可以让家长方便地观察孩子学习情况，从这里可以有适合的方法教导他们而且也让父母比较安心。
要一个新生他叫大明。	有一个新生他叫大明。
有一天，他们爸爸回家的时候非常难过。妈妈问她：「怎么了？」	有一天，他们爸爸回家的时候非常难过。妈妈问他：「怎么了？」
当在家里可以多点培养兴趣，列入调整房子、做菜等等，让自己、丈夫跟孩子过得更舒服一点。	当在家里可以多点培养兴趣，例如调整房子、做菜等等，让自己、丈夫跟孩子过得更舒服一点。
我最喜欢哪个地方！	我最喜欢那个地方！
对我们的还清而健康有很多问题。因为这件事，最近我们的孩子们都有健康的问题。	对我们的环境和健康有很多问题。因为这件事，最近我们的孩子们都有健康的问题。
如您方于一个礼拜之内未处理我们区民将会之环保局提出诉状，至时相信此事将对于您工厂不利。	如您方于一个礼拜之内未处理我们居民将会之环保局提出诉状，至时相信此事将对于您工厂不利。
没想到，怎么会下大雨，他们不能考食物了。	没想到，怎么会下大雨，他们不能烤食物了。
可是话说回来，他讲的话过路不礼貌，且伤害别人的心，这种话不应该说出来的。	可是话说回来，他讲的话过度不礼貌，且伤害别人的心，这种话不应该说出来的。
我们的大人们都已近无法接受那些吵吵闹闹的声音、更是我们对声音比较铭感的婴儿与孩子们。	我们的大人们都已经无法接受那些吵吵闹闹的声音、更是我们对声音比较敏感的婴儿与孩子们。
美英你一定会很不开心，因为哪些钱对你来说并不是很少。	美英你一定会很不开心，因为那些钱对你来说并不是很少。
第一天不错我很轻松，我新的中文老师是我好朋有，还有我紧张的感觉结束了。	第一天不错我很轻松，我新的中文老师是我好朋友，还有我紧张的感觉结束了。
我本来要参加这个会的，可是我今天有一点儿事情一定要做完。	我本来要参加这个会的，可是我今天有一点儿事情一定要做完。
妈妈说：「为什么这个事情会让他怎么难过呢？」	妈妈说：「为什么这个事情会让他这么难过呢？」
因此有的父母会决得小孩子应尽早开始正规教育，以便给自己上良好的大学的机会，然后工作会比较好找。	因此有的父母会觉得小孩子应尽早开始正规教育，以便给自己上良好的大学的机会，然后工作会比较好找。
近畿年来，科技发达，社会生活品质提升，很多家庭是因为随著这个著潮流而人际关系也渐渐远离。	近几年来，科技发达，社会生活品质提升，很多家庭是因为随著这个著潮流而人际关系也渐渐远离。
幸亏没有一个台湾人不会很热心地帮助本本的老外找到师大国语教学中心，要不然师大国语教学中心就没有学生，再说不能赚钱。	幸亏没有一个台湾人不会很热心地帮助笨笨的老外找到师大国语教学中心，要不然师大国语教学中心就没有学生，再说不能赚钱。
现在我在宿舍，你不在这哩。	现在我在宿舍，你不在这里。
我打电话各我妈妈爸爸也打不通。	我打电话给我妈妈爸爸也打不通。
下个星期五是我的生日，所以我要开一个无会。	下个星期五是我的生日，所以我要开一个舞会。
我门的依服通通都葬了，肉也还没吃。	我们的衣服通通都脏了，肉也还没吃。
我很开兴知道你们五月二十日就要结婚了。	我很开心知道你们五月二十日就要结婚了。
他赶紧换上依服冲到公车站等公车，可是等那么久公车都还没来让他更著急！	他赶紧换上衣服冲到公车站等公车，可是等那么久公车都还没来让他更著急！
花莲台东的风景气势磅礡、澎湖的景观是人间仙境，要是这两各地方的可贵自然美都被破坏了，台湾反而就是去了观光的吸引力。	花莲台东的风景气势磅礡、澎湖的景观是人间仙境，要是这两个地方的可贵自然美都被破坏了，台湾反而就失去了观光的吸引力。
对我来说、我不喜欢这个改装。因为您要做的是没有各人的秘密。	对我来说、我不喜欢这个改装。因为您要做的事没有个人的秘密。
他杏林，叫小安。	他姓林，叫小安。
我认为打工教学生根陌生人在自然的环境相处，而是不同行业的人，不像学校只有老师和同学的环境。	我认为打工教学生跟陌生人在自然的环境相处，而是不同行业的人，不像学校只有老师和同学的环境。
住在附近您的工厂的人都很生气，我也很生气，为甚么在我们自己的环境不能过瘾很好的生活？所以我写了这封信骑给您表达我们的景况。	住在附近您的工厂的人都很生气，我也很生气，为甚么在我们自己的环境不能过一很好的生活？所以我写了这封信寄给您表达我们的景况。
我们急忙的前往马偕医院急诊室就诊，医师诊断为＂进食农药导致食物中毒＂。	我们急忙地前往马偕医院急诊室就诊，医师诊断为＂进食农药导致食物中毒＂。
第一个介意我们觉得如果你们工厂搬到别的地方好像在山上附近还是搬到比较没有房子那么多，在山上附近可能比较好，地方也比较适合你们，也比较不会那么贵。	第一个建议我们觉得如果你们工厂搬到别的地方好像在山上附近还是搬到比较没有房子那么多，在山上附近可能比较好，地方也比较适合你们，也比较不会那么贵。
我中午十二点中来找您，因为我票告诉您，我明天不能来上课。	我中午十二点中来找您，因为我要告诉您，我明天不能来上课。
感觉到无可奈何，不知道怎么办在行了。	感觉到无可奈何，不知道怎么办才行了。
大家本来以为会慢慢消失，但过了差不多一个月的时间嗓音和臭味不但没减少而且越加重。	大家本来以为会慢慢消失，但过了差不多一个月的时间噪音和臭味不但没减少而且越加重。
还有要跟你说一件好事，全球经济危机帮我瘦３工斤。	还有要跟你说一件好事，全球经济危机帮我瘦３公斤。
但最近从工厂里头发出嗓音和臭味让邻居们很不舒服，这件事已经发生有几个礼拜了。	但最近从工厂里头发出噪音和臭味让邻居们很不舒服，这件事已经发生有几个礼拜了。
因为你的国家远得不得了，再说你一个礼拜用很多衣服，所以我看到的红虹大大的包包我觉得你一定要买。	因为你的国家远得不得了，再说你一个礼拜用很多衣服，所以我看到的红红大大的包包我觉得你一定要买。
也请李长为永康工业区民主解释为什么会发生这些问题，帮我们清洁永康工业区的水沟也因为您们的工厂垃圾发出臭味。	也请李长为永康工业区邻居解释为什么会发生这些问题，帮我们清洁永康工业区的水沟也因为您们的工厂垃圾发出臭味。
上个星期你请客，所以明天我想情你去一家法国餐厅吃法国菜。	上个星期你请客，所以明天我想请你去一家法国餐厅吃法国菜。
六点半，他到火车站，所以他很高现。	六点半，他到火车站，所以他很高兴。
差不多十点大卫岗来大学。	差不多十点大卫刚来大学。
现在，电脑与网际网路发达、快速的发展，人跟人之间的距离也为了这样变的更近。	现在，电脑与网际网路发达、快速的发展，人跟人之间的距离也为了这样变得更近。
人民天天在经济珐展的气氛中而高高兴兴得生活。	人民天天在经济发展的气氛中而高高兴兴得生活。
像这样的情况之下，请您替我们这些老人早想。	像这样的情况之下，请您替我们这些老人著想。
即使我们是受害者，我不求任何的赔偿，只希望贵单位能够更彻底的实行产品检验，避免这种恶梦再度重演。	即使我们是受害者，我不求任何的赔偿，只希望贵单位能够更彻底地实行产品检验，避免这种恶梦再度重演。
音和臭味影响大家的环境，不能让邻居狗舒服的日子。	音和臭味影响大家的环境，不能让邻居过舒服的日子。
尤其是医疗方面系所的学费，差不多买的到一个房子一样贵！	尤其是医疗方面系所的学费，差不多买得到一个房子一样贵！
我真的也应该问你工作上顺不顺尤其是经过了最近的经济不景济的这一段时间。	我真的也应该问你工作上顺不顺尤其是经过了最近的经济不景气的这一段时间。
几年前，我碰到这样的情况。那时，我跟几个朋友组在一起。	几年前，我碰到这样的情况。那时，我跟几个朋友住在一起。
医生跟他说：你一定最少每个星期运动两次，要不然你的身体不输服，你的头会容易疼。	医生跟他说：你一定最少每个星期运动两次，要不然你的身体不舒服，你的头会容易疼。
我今天早上看到你的信觉得很开心，好像好九没有看到你的字了。	我今天早上看到你的信觉得很开心，好像好久没有看到你的字了。
日前收到你的电子邮件，我能感受到你被无赖的感受。	日前收到你的电子邮件，我能感受到你被诬赖的感受。
天气真不错，他们很开心的一边聊天一边烤肉。	天气真不错，他们很开心地一边聊天一边烤肉。
因为我不是学生，而且也不是老使，所以我对「教室里该不装了摄影机」的事情没有特别的立场。	因为我不是学生，而且也不是老师，所以我对「教室里该不装了摄影机」的事情没有特别的立场。
天起那里不怎么好。	天气那里不怎么好。
回国前应该先拿它的钱去买，不然就是送礼物罢了。	回国前应该先拿他的钱去买，不然就是送礼物罢了。
可是，能有多少人知道现在北极冰荣化的很严重，我们的地球越来越热，天灾不段的发生等，原因何在呢？	可是，能有多少人知道现在北极冰融化的很严重，我们的地球越来越热，天灾不断地发生等，原因何在呢？
我确定大部分的妇女为了保证他们孩子的安全会真天看学校的网站	我确定大部分的妇女为了保证他们孩子的安全会整天看学校的网站
次外，我也知道这你早就爱个行业。	此外，我也知道这你早就爱个行业。
记得前三年我妈因为工作效果最高，所以公司奖给他去日本旅行。	记得前三年我妈因为工作效果最高，所以公司奖给她去日本旅行。
这个旅行是天两夜，印度的南部很漂亮，风景也很美。	这个旅行四天两夜，印度的南部很漂亮，风景也很美。
如果在教室里有一个问题，我们家常会这道为甚么会发生这件事而这道谁对谁做错。	如果在教室里有一个问题，我们家长会知道为甚么会发生这件事而这道谁对谁做错。
受到你的信我很高兴！也很想回信，可是我一忙就忘了。	收到你的信我很高兴！也很想回信，可是我一忙就忘了。
我希望很多人支持您的作法，谢谢您看我的信。	我希望很多人支持您的做法，谢谢您看我的信。
我知到你会难过，要是我啊，我也会伤心难过啊，可是你也要想要是你是他，你会怎样。	我知道你会难过，要是我啊，我也会伤心难过啊，可是你也要想要是你是他，你会怎样。
因为教室里的摄影机让校厂和其他的老师看到老师的上课的情况，老师一定要热情地上课，为了提高小朋友学习上的兴趣。	因为教室里的摄影机让校长和其他的老师看到老师的上课的情况，老师一定要热情地上课，为了提高小朋友学习上的兴趣。
请利用您们的能力协助，要不然我联络报字上面几位作家写一篇文章告诉我们的人民这件事。	请利用您们的能力协助，要不然我联络报纸上面几位作家写一篇文章告诉我们的人民这件事。
可是由于全地球越来越改变，全地球越来越脏。有的动植物已经不见了。还有有的动植物可能快要不见。这件事对我们的孩子来说真得不好的事。	可是由于全地球越来越改变，全地球越来越脏。有的动植物已经不见了。还有有的动植物可能快要不见。这件事对我们的孩子来说真的不好的事。
所以恐怕我不能参加你的怕对，对不起啊！	所以恐怕我不能参加你的派对，对不起啊！
我的碰妞要吃这个东西。	我的朋友要吃这个东西。
奴人结婚生孩子以后，最好是妈妈自己照顾孩子，如果妈妈每天工作就没办法有好好儿的方法照顾孩子，照顾孩子最重要是妈妈的爱。	女人结婚生孩子以后，最好是妈妈自己照顾孩子，如果妈妈每天工作就没办法有好好儿的方法照顾孩子，照顾孩子最重要是妈妈的爱。
我们已经约会时间，我们真得没有办法去，因为我一定来不起。	我们已经约会时间，我们真的没有办法去，因为我一定来不及。
我跟你说你最好不要抱者太大的希望跟大年要钱，照我的经验他就是不会还给你。	我跟你说你最好不要抱著太大的希望跟大年要钱，照我的经验他就是不会还给你。
这样，大家看，会直得吗？我们这个人类是不是太自私，太残忍了？	这样，大家看，会值得吗？我们这个人类是不是太自私，太残忍了？
我希望你很快回复你的健康！那么你好好得休息。	我希望你很快恢复你的健康！那么你好好得休息。
因为我家的风景跟美。	因为我家的风景很美。
除了自由自在意外，另外一个就是小朋友需要学会自己怎么去处理任何问题、冒出来的困扰、跟朋友们的冲度、等等。	除了自由自在以外，另外一个就是小朋友需要学会自己怎么去处理任何问题、冒出来的困扰、跟朋友们的冲突、等等。
虽然工作有点压力，不过我一直都听你花，保持每天都运动，所以，身体很好。	虽然工作有点压力，不过我一直都听你话，保持每天都运动，所以，身体很好。
她会说日文，所以我们说会的时候，没有问题。	她会说日文，所以我们说话的时候，没有问题。
最近在新闻长报导说很多小孩儿跳楼自杀，原因是因为达不到父母的要求。	最近在新闻常报导说很多小孩儿跳楼自杀，原因是因为达不到父母的要求。
你小的时候总视看了这个杂志，所以我很高兴你可能找到这个工作！	你小的时候总是看了这个杂志，所以我很高兴你可能找到这个工作！
东方人有时说话不像西方来的直接坦率，他们有时只是出于礼貌。	东方人有时说话不像西方来得直接坦率，他们有时只是出于礼貌。
我要跟同学说，做工课，作业，第二天把它带来，所以请你放心。	我要跟同学说，做功课，作业，第二天把它带来，所以请你放心。
每天匆匆忙忙得睡眠不够，心情没有宽裕的话，生活不能说是充实而只是痛苦。	每天匆匆忙忙地睡眠不够，心情没有宽裕的话，生活不能说是充实而只是痛苦。
我也觉得这件事，如果在这样下去，大家都会面临困难。	我也觉得这件事，如果再这样下去，大家都会面临困难。
在面临这问题时，老师们会从录影过的一片来反省自己的教法、应付学生们的方式、注意那些学生需要特别的照顾等等。	在面临这问题时，老师们会从录影过的影片来反省自己的教法、应付学生们的方式、注意哪些学生需要特别的照顾等等。
我在家长的立长来说，对于这件事我很赞成在教室装了录影机。	我在家长的立场来说，对于这件事我很赞成在教室装了录影机。
我觉得最好是装录影机是好的想法但是要给家人看到他们的小孩子上课跟下课做甚么事情、老师对学生怎么样、怎么教小孩、玩那一种游戏、吃甚么东西这个都很重要。	我觉得最好是装录影机是好的想法但是要给家人看到他们的小孩子上课跟下课做甚么事情、老师对学生怎么样、怎么教小孩、玩哪一种游戏、吃甚么东西这个都很重要。
这样的研究结果引起了他家的主目，而且就学的竞争越来极烈，人民急急忙忙地把孩子推到补习班去了。	这样的研究结果引起了他家的注目，而且就学的竞争越来极烈，人民急急忙忙地把孩子推到补习班去了。
还有，一个问题！操音很大声，我每天睡也睡不觉，中午的时间也是，我们看电视的时候也为了做大声音是我们看电视的音响听不到！	还有，一个问题！噪音很大声，我每天睡也睡不觉，中午的时间也是，我们看电视的时候也为了做大声音是我们看电视的音响听不到！
我看到那些没有工作的人，真的好可怜，有一吨没一吨的。	我看到那些没有工作的人，真的好可怜，有一顿没一顿的。
那时候你就可以正常的上下班，你要忍耐一下，我希望你公司很快就恢复起来。	那时候你就可以正常地上下班，你要忍耐一下，我希望你公司很快就恢复起来。
由于年纪已经不轻，所以要再从新找一份工作，对他来说是如此艰难的事啊！	由于年纪已经不轻，所以要再重新找一份工作，对他来说是如此艰难的事啊！
今天对大伟来说，不可望这么好的老师。	今天对大伟来说，不可忘这么好的老师。
到了一家商店，我们休葸一会儿。	到了一家商店，我们休息一会儿。
我觉得在教室里，装了摄影机对家长很有利，我赞同这种作法。	我觉得在教室里，装了摄影机对家长很有利，我赞同这种做法。
我觉得你可以请一些我们同学来玩，好不好？我快要有一些理物送给你。	我觉得你可以请一些我们同学来玩，好不好？我快要有一些礼物送给你。
然后有打过工的人遇到困境，可能对策得技巧与社会生活适应得较好。	然后有打过工的人遇到困境，可能对策的技巧与社会生活适应得较好。
世界上有各种各样的人，当然有许多好人，不过世界仍具有繁多坏人如小偷、强盗等，因此偷钱包的事情现今倒处很容易发生。	世界上有各种各样的人，当然有许多好人，不过世界仍具有繁多坏人如小偷、强盗等，因此偷钱包的事情现今到处很容易发生。
我门打篹很久要去看他，所以我不可能参家你的会。	我们打算很久要去看他，所以我不可能参加你的会。
英国的批具很好喝，我很喜欢！	英国的啤酒很好喝，我很喜欢！
不要造成自己的困扰、请你好好想一想、尽快帮我们处理。多谢您。	不要造成自己的困扰、请你好好想一想、尽快帮我们处理。多谢您。
他到了公车占九看很多人等著公车。	他到了公车站就看很多人等著公车。
我的看法是如何呢？我持者「不要设定限制」的态度。	我的看法是如何呢？我持著「不要设定限制」的态度。
老师跟小孩的关事是好的话、解决很多问题。	老师跟小孩的关系是好的话、解决很多问题。
我觉得中国子太难，不过很有意思。	我觉得中国字太难，不过很有意思。
我昨天打电话给了你妈妈，她说你感冒住院了，我听了以后真得很担心。	我昨天打电话给了你妈妈，她说你感冒住院了，我听了以后真的很担心。
他们就是在教室里不会做这样的事情，可是一道家里就继续做他喜欢的坏事。	他们就是在教室里不会做这样的事情，可是一到家里就继续做他喜欢的坏事。
你多出来的那三天，可以去找一些自我培养的课程，多学一些新的才能。其实现在外面有许多这种支援。	你多出来的那三天，可以去找一些自我培养的课程，多学一些新的才能。其实现在外面有许多这种资源。
大家帮他找了课本一整天，可是却没有找得到，那时候那个同学怀疑我的说「环我我的课本！」	大家帮他找了课本一整天，可是却没有找得到，那时候那个同学怀疑我的说「还我我的课本！」
现在网路已经可以无限上网以及数度变很快，网路已经变成无所不在了。	现在网路已经可以无限上网以及速度变很快，网路已经变成无所不在了。
但是关于古克力，他好像就会发疯了，行为就会变贵贵的。	但是关于古克力，他好像就会发疯了，行为就会变怪怪的。
春天跟愁天很舒服。冬天很冷，夏天很热，所以我不很喜两个季节。	春天跟秋天很舒服。冬天很冷，夏天很热，所以我不很喜两个季节。
你看，你的情况不是那吗夸张。	你看，你的情况不是那么夸张。
这样就可以放便多了。以我个性不想麻烦又喜欢动物的人，这重设备是满不错的。	这样就可以方便多了。以我个性不想麻烦又喜欢动物的人，这种设备是满不错的。
我个没关系，但是大家有小孩有老人还有病人，所以这问题邀不能不解决。	我个没关系，但是大家有小孩有老人还有病人，所以这问题要不能不解决。
可是最重要的事要好好的痒孩子。	可是最重要的是要好好地养孩子。
简单的说，他每天先去各地在路上问民众问题，然后回公司写草稿。	简单地说，他每天先去各地在路上问民众问题，然后回公司写草稿。
大部分的人会把经济率退视为发展的障碍，其实你能把握这时增加你的潜力。	大部分的人会把经济衰退视为发展的障碍，其实你能把握这时增加你的潜力。
昨天夜里，我跟俩个朋友去玩！	昨天夜里，我跟两个朋友去玩！
天明到厨房去拿啤酒跟絣干，请他的朋友一边看电视一边吃絣干、喝啤酒。	天明到厨房去拿啤酒跟饼干，请他的朋友一边看电视一边吃饼干、喝啤酒。
因为是世界排第一名管理学院，他的关系很好而培养她很深远懂理财这个行业。	因为是世界排第一名管理学院，她的关系很好而培养她很深远懂理财这个行业。
你是大老板也是很大方，明天你要在那里吃饭还要吃什么我都愿意。	你是大老板也是很大方，明天你要在哪里吃饭还要吃什么我都愿意。
但是有很多课程不因该在电脑上教，例如语言、阅读、写作等。	但是有很多课程不应该在电脑上教，例如语言、阅读、写作等。
吃饭了以后，我拍了很多照篇。	吃饭了以后，我拍了很多照片。
每个站都不一样，每个很票亮。	每个站都不一样，每个很漂亮。
对不起，今回我不能一起去，那个时候，我要去公作的流行。	对不起，今回我不能一起去，那个时候，我要去工作的旅行。
他的老师早几天佑对他门说，不要忘记，学生们要明天早来，我要为你们备一种考试。	他的老师早几天有对他们说，不要忘记，学生们要明天早来，我要为你们备一种考试。
他看到了一辆红汽车，就决定叫那个人定车。	他看到了一辆红汽车，就决定叫那个人停车。
电话里便提到要退休的事，我能了解你的意思。	电话里边提到要退休的事，我能了解你的意思。
因为你的工厂的垃圾每天累积，不臭吗？应该快开始夏天的关西也有，可是怎么那么臭的，我觉得，现在越来越臭的！	因为你的工厂的垃圾每天累积，不臭吗？应该快开始夏天的关系也有，可是怎么那么臭的，我觉得，现在越来越臭的！
但是可以说如果钱真的不过用的话，我可以随时告诉父母。	但是可以说如果钱真的不够用的话，我可以随时告诉父母。
这是我们共同的困难阶段，你不是常常跟我说雨后是彩虹码？	这是我们共同的困难阶段，你不是常常跟我说雨后是彩虹吗？
过去的几年来，新闻一值播出青少年玩电脑比学习还多。	过去的几年来，新闻一直播出青少年玩电脑比学习还多。
我妈妈伤病了所以我得去看他。	我妈妈生病了所以我得去看他。
他是很用功的人，所以很总明。	他是很用功的人，所以很聪明。
助你身体健康。	祝你身体健康。
教室里的互动是和复杂的事情，每个人对教育方法都有自己的想法。	教室里的互动是很复杂的事情，每个人对教育方法都有自己的想法。
如果您哪里真的有事情不能回来．．．还是我这里想办法先处理吧！	如果您那里真的有事情不能回来．．．还是我这里想办法先处理吧！
李台生要回去，但是我到了旁边的路没有车可以做回去。	李台生要回去，但是我到了旁边的路没有车可以坐回去。
十分钟以后他的老师进来，大明看大的老师就知道他的老师是女生在马路，老师也认到大明社男生问他捷运站怎么走。	十分钟以后他的老师进来，大明看他的老师就知道他的老师是女生在马路，老师也认到大明是男生问他捷运站怎么走。
海！我要告诉你一个故事。	嗨！我要告诉你一个故事。
因为二十年前，我的父母亲都已经过时了，很平穷的我也只能够依靠自己存下来的钱。	因为二十年前，我的父母亲都已经过世了，很贫穷的我也只能够依靠自己存下来的钱。
如果在教室内装了摄影机，这样恐怕子女们会害怕，会加重他们的压力，影响严重到他们的成绩。这样的看法真得太过天真。	如果在教室内装了摄影机，这样恐怕子女们会害怕，会加重他们的压力，影响严重到他们的成绩。这样的看法真的太过天真。
以前在大学的时候，都是你鼓励我们，先宰我们更鼓励。加油。你做得到！	以前在大学的时候，都是你鼓励我们，现在我们更鼓励。加油。你做得到！
我希望你的病越来越好，身体越来越建康。	我希望你的病越来越好，身体越来越健康。
你以前不是常常拿中国伟大历史人物司马迁和世界级音乐名家贝托芬的故事来鼓励我积极向上吗？	你以前不是常常拿中国伟大历史人物司马迁和世界级音乐名家贝多芬的故事来鼓励我积极向上吗？
我妈妈在一所大学当国际经济学的班主任同时他担任会计老师，当老师的职业也很辛苦，学校的事也不少。	我妈妈在一所大学当国际经济学的班主任同时她担任会计老师，当老师的职业也很辛苦，学校的事也不少。
回家时爸妈还可以跟妳说妳哪里表现得不够理想，比如说你有没有常常举手回答老师的问题，你上课时给谁写了情书，等等。	回家时爸妈还可以跟你说你哪里表现得不够理想，比如说你有没有常常举手回答老师的问题，你上课时给谁写了情书，等等。
你的爸爸真得是坏人！他应该不让你喝酒！	你的爸爸真的是坏人！他应该不让你喝酒！
我只是希望经济的循环便好的方向。如果继续维持现在的洋相，我怕再回归之前美国的大供皇。	我只是希望经济的循环变好的方向。如果继续维持现在的洋相，我怕再回归之前美国的大恐慌。
摄影机记录学生的念书行为，可以帮助老师提申教学品质。	摄影机记录学生的念书行为，可以帮助老师提升教学品质。
应为他学得很好，所以同班同学都喜欢问他问题。	因为他学得很好，所以同班同学都喜欢问他问题。
许多大学生，觉得自己可以赚钱，就随便花钱、随便浪费，反正觉得用得也是自己的钱嘛！	许多大学生，觉得自己可以赚钱，就随便花钱、随便浪费，反正觉得用的也是自己的钱嘛！
要是您们把这问题方在一边不理！我们会向法院起诉。	要是您们把这问题放在一边不理！我们会向法院起诉。
我赞同这个方法是因为有以下的机种理由。	我赞同这个方法是因为有以下的几种理由。
如果适合的活，带来最好的效果才算是好的一个方法。	如果适合的话，带来最好的效果才算是好的一个方法。
我想告诉妳一个东西：妳会时后，我可以帮妳买东西。请妳会家时后打给我。	我想告诉妳一个东西：妳回时候，我可以帮妳买东西。请妳回家时候打给我。
传统食物各个地方都有，可是一般印尼到底的菜融合在雅加大相：咖哩鸡饭；炒饭；牛肉丸面；烤肉等等很容易找。	传统食物各个地方都有，可是一般印尼到底的菜融合在雅加大像：咖哩鸡饭；炒饭；牛肉丸面；烤肉等等很容易找。
我又跟他连络。我打来大去好几次，他还接电。	我又跟他连络。我打来打去好几次，他还接电。
他目前在一个书店工作，每周一天，一天四个小时，这样工作就不会影响到她的学习。	她目前在一个书店工作，每周一天，一天四个小时，这样工作就不会影响到她的学习。
但碰到这样的烦恼我真的不可奈何。	但碰到这样的烦恼我真的无可奈何。
我代表邻居们有一下意见跟建议给你们工厂有关于噪音和臭味问题。	我代表邻居们有一些意见跟建议给你们工厂有关于噪音和臭味问题。
要是每一所，不但是小学，或是大学都能够这么做，那么家长再也不会担心孩子们在学校过的如何了。	要是每一所，不但是小学，或是大学都能够这么做，那么家长再也不会担心孩子们在学校过得如何了。
如果我有小孩子的话，我不烧得我不会跟他们一样支持在教室里面装摄影机。	如果我有小孩子的话，我不晓得我不会跟他们一样支持在教室里面装摄影机。
因此我们区民都对您工厂附近的味道与环境上反感。	因此我们居民都对您工厂附近的味道与环境上反感。
张爱文很聪明，老师教他英文、地理什么得，他很快明白了。	张爱文很聪明，老师教他英文、地理什么的，他很快明白了。
我门家的人要去野餐座空空汽车。	我们家的人要去野餐坐公共汽车。
虽然每次租狗的时候，要付钱，但是租宠物不会制造麻烦、问题。	虽然每次租狗的时候，要付钱，但是租宠物不会制造麻烦、问题。
我项在有一个月的空，可是我还没决定我做什么。	我现在有一个月的空，可是我还没决定我做什么。
有的时候反对一些裁板说的，他门就生气因为叫的搓有一点不公平，他们就大骂大叫。	有的时候反对一些裁判说的，他们就生气因为叫的说有一点不公平，他们就大骂大叫。
到日本他看见他的朋友腾她，他的朋友请她一起吃午饭。	到日本他看见他的朋友等她，他的朋友请她一起吃午饭。
今天没有那么多功课，所以他打算叫小妹妹跟他一起去电影院。	今天没有那么多功课，所以他打算叫小美美跟他一起去电影院。
希望你身体快好起来，回复以前的大明很活力。	希望你身体快好起来，恢复以前的大明很活力。
而且你到现在忙得不得了。没有自己的时间和跟妈妈一起出去的时间。所以以后我想让你要好好的休息。	而且你到现在忙得不得了。没有自己的时间和跟妈妈一起出去的时间。所以以后我想让你要好好地休息。
西班牙的朋友做西班牙菜，法国的朋友做法国菜，德国的朋友也做德国菜，甚么的。都很好吃，都特别的外套。	西班牙的朋友做西班牙菜，法国的朋友做法国菜，德国的朋友也做德国菜，甚么的。都很好吃，都特别的味道。
虽仍已经大部分的人家做法了防音和臭味对策，可是大家还有这个问题。	虽然已经大部分的人家做好了防音和臭味对策，可是大家还有这个问题。
我认为现在每个人不管男生还是女生，都可以上课上班，也可以做好得工作。	我认为现在每个人不管男生还是女生，都可以上课上班，也可以做好的工作。
我要词反。	我要吃饭。
以前都很希望可以每个学期修一两门课而已，这样我研究的科目能够薰陶我的心力让我好好笑话拿份专业知识，也能同时由精神管理工作和家庭的事情。	以前都很希望可以每个学期修一两门课而已，这样我研究的科目能够薰陶我的心力让我好好消耗拿份专业知识，也能同时有精神管理工作和家庭的事情。
女性再工作上的地位，已经逐渐跟男性一样了。	女性在工作上的地位，已经逐渐跟男性一样了。
他的老师：「你怎嚜了？」，李大明说：「我头痛。」。	他的老师：「你怎么了？」，李大明说：「我头痛。」。
我觉得会费精神来用摄影机观擦自己的孩子是因为他们不信任孩子在学校里都做了什么事，每天那么怀疑他们只会产生不好的关系。	我觉得会费精神来用摄影机观察自己的孩子是因为他们不信任孩子在学校里都做了什么事，每天那么怀疑他们只会产生不好的关系。
一家好的工厂就是展品好，但也要看重别人的身体健康。	一家好的工厂就是产品好，但也要看重别人的身体健康。
老师可能教一个题目但是有的学生不懂她的意思可是她不会帮他们懂这个问题，这事不好的教法因为老师应该帮学生学习很好。	老师可能教一个题目但是有的学生不懂她的意思可是她不会帮他们懂这个问题，这是不好的教法因为老师应该帮学生学习很好。
万一李厂长不处理这件事的话，我们会报告这件事给政府、报纸和星闻让你们的工厂永远关门。其是我们不必这样做如果您会处理这件事。	万一李厂长不处理这件事的话，我们会报告这件事给政府、报纸和新闻让你们的工厂永远关门。其实我们不必这样做如果您会处理这件事。
我今天早上在乡下看一些很漂亮的风京。	我今天早上在乡下看一些很漂亮的风景。
看我朋友完全陷入了这个恶心循环，我就下定决心不要再打网路游戏了。	看我朋友完全陷入了这个恶性循环，我就下定决心不要再打网路游戏了。
比如说上司、同事、朋友、有可能先生也说：「为什么继续工作呢？离职工作党个家庭主妇比较好」。	比如说上司、同事、朋友、有可能先生也说：「为什么继续工作呢？离职工作当个家庭主妇比较好」。
台湾是水果丰富的一中国家。	台湾是水果丰富的一种国家。
周末的时候，我常常跟他一起去看电影。	周末的时候，我常常跟他一起去看电影。
如果不是很大的问题我不会拜托您们呢，所以请先您们想一想方法这么样可以处理？	如果不是很大的问题我不会拜托您们呢，所以请先您们想一想方法怎么样可以处理？
她教我怎吗去学校了。	她教我怎么去学校了。
如果从古代来说：大部分的女人结婚后，职在家当家庭主妇，专心照顾先生，孩子。	如果从古代来说：大部分的女人结婚后，只在家当家庭主妇，专心照顾先生，孩子。
所以李工厂应该买比较安警的机，他们也应该找不臭的资源，这个办法会让我们的城市很干净。	所以李工厂应该买比较安静的机，他们也应该找不臭的资源，这个办法会让我们的城市很干净。
明天我不能来上课，因为我要参加奖学金的烤试。	明天我不能来上课，因为我要参加奖学金的考试。
在日本，大学生打工的情况是相当普偏的。	在日本，大学生打工的情况是相当普遍的。
何况在台湾当留学生，同学会觉得你的渔塭成都是跟他们一样的，同学会包容你喂他们的一份子，所他们理所当然的事也延到我们身边来。	何况在台湾当留学生，同学会觉得你的语文程度是跟他们一样的，同学会包容你为他们的一份子，所他们理所当然的事也延到我们身边来。
八点上班根７、８点下班对你的工人也比较好。	八点上班跟７、８点下班对你的工人也比较好。
观察自己的行为是个好用处的习惯，不然在学习或工作的环境你必需集中在工作、学习为了做到、学到成功。	观察自己的行为是个好用处的习惯，不然在学习或工作的环境你必须集中在工作、学习为了做到、学到成功。
您们工厂用的化学原料，应为那些原料太臭、我最近有头痛。我去过看医生、他说这一个原因是您们的化学原料。	您们工厂用的化学原料，因为那些原料太臭、我最近有头痛。我去过看医生、他说这一个原因是您们的化学原料。
因为有很多人用了电脑跟家人、客人、同学、同事沟通，他们就像也可以用电脑交朋友。	因为有很多人用了电脑跟家人、客人、同学、同事沟通，他们就想也可以用电脑交朋友。
王天华自己知道错了马上跟爸妈说对不起，他爸妈没有骂他只说他以后不可以这样者。	王天华自己知道错了马上跟爸妈说对不起，他爸妈没有骂他只说他以后不可以这样子。
她长大了便很帅！	她长大了变很帅！
如果老师做不好的事情，家长可以马上告诉老师他的措施在哪里，所以会马上改一改哪一方面是错的。	如果老师做不好的事情，家长可以马上告诉老师他的错是在哪里，所以会马上改一改哪一方面是错的。
因为其是明天我有考试，所以今天不可以去看你。	因为其实明天我有考试，所以今天不可以去看你。
我觉得装这种东西的予算是浪费，这位校长可能只想赚钱。	我觉得装这种东西的预算是浪费，这位校长可能只想赚钱。
我知道支持的人很多，也可以理解他们为什么支持这个作法。	我知道支持的人很多，也可以理解他们为什么支持这个做法。
孩子也无法吸收这两种基本且重要的教育的精随。	孩子也无法吸收这两种基本且重要的教育的精髓。
但是如果茶余饭后大家提起网路交友的话题，我必定会积极的反对！	但是如果茶余饭后大家提起网路交友的话题，我必定会积极地反对！
我们提针下列方法、加一张壁板在工厂围周、加废弃气回收机在屋顶、废弃水虑可机等。	我们提针下列方法、加一张壁板在工厂围周、加废弃气回收机在屋顶、废弃水滤可机等。
对噪音的问题，工厂要做隔音墙，或者用除旧换新的方法把旧的，会发出噪音的契机淘汰掉。	对噪音的问题，工厂要做隔音墙，或者用除旧换新的方法把旧的，会发出噪音的器机淘汰掉。
那时候他看到一个女生，他马上问她到学校怎嚜走。	那时候他看到一个女生，他马上问她到学校怎么走。
很多人认为，德国蔡是很油腻的。	很多人认为，德国菜是很油腻的。
他喝很多酒，回家的时候很累，头很通所以他起床不了。	他喝很多酒，回家的时候很累，头很痛所以他起床不了。
我劝告你千万不要放弃，要再接再厉继续认真得追求上班。	我劝告你千万不要放弃，要再接再厉继续认真地追求上班。
不过那些养宠物的人都对自己的宠物有爱心，不像「宠物出租」的顾客只要一断的时间要照顾它们。	不过那些养宠物的人都对自己的宠物有爱心，不像「宠物出租」的顾客只要一段的时间要照顾它们。
因为大的家里学校很远，所以他要早一点起来。	因为他的家离学校很远，所以他要早一点起来。
他每天每天起床六点半因为他的家离大学很远，可是他很用空所以他觉得每天很早起床让她太累。	他每天每天起床六点半因为他的家离大学很远，可是他很用功所以他觉得每天很早起床让她太累。
我希望以他们的安全保证书来解决这个问题。不能提出安全保证书的话，应该停止营业。	我希望以他们的安全保证书来解决这个问题。不能提出安全保证书的话，应该停止营业。
除了改成营业时间以外还要求为了预防嗓音跟臭味的问题你们修改设备。	除了改成营业时间以外还要求为了预防噪音跟臭味的问题你们修改设备。
我真要去看这些地方，因为我也也是台湾人。	我真要去看这些地方，因为我爷爷是台湾人。
他说他等公车等了一半小时，所以他来学姣很晚。	他说他等公车等了一半小时，所以他来学校很晚。
我有将学金。	我有奖学金。
老师们也可以观察哪一个学生需要指教，哪一些学生很活泼，这样可以让老师更了解平常部会很容易观察到的学生们。	老师们也可以观察哪一个学生需要指教，哪一些学生很活泼，这样可以让老师更了解平常不会很容易观察到的学生们。
我觉得他票亮得很。	我觉得他漂亮得很。
冬天的是后天气热得不得了。	冬天的时候天气热得不得了。
问题就是「半工半读」又两片影像，又好处并也存在坏处。	问题就是「半工半读」有两边影响，有好处并也存在坏处。
大多的现代人慎怕小朋友会出什么问题，而紧迫钉人。	大多的现代人深怕小朋友会出什么问题，而紧迫盯人。
因为时常熬夜以致于我身体状况变差，因为抵抗力下降，皮肤长了痲疹，医生吩咐我要早点睡。	因为时常熬夜以致于我身体状况变差，因为抵抗力下降，皮肤长了麻疹，医生吩咐我要早点睡。
而且我们下办的时候也很快乐跟孩子了他们在教室里的学习跟朋有生活上沟通，决绝问题。跟孩子沟通不是比看摄影机快乐吗？	而且我们下班的时候也很快乐跟孩子聊他们在教室里的学习跟朋友生活上沟通，解决问题。跟孩子沟通不是比看摄影机快乐吗？
我到办公至找您，可是您不在。	我到办公室找您，可是您不在。
我要买一件衣服更一个照相机。	我要买一件衣服跟一个照相机。
去万很累，可是很有意思。	去玩很累，可是很有意思。
如果在教室里有纠纷，可以利用录影党当证据。	如果在教室里有纠纷，可以利用录影档当证据。
我明天不难去上课。	我明天不能去上课。
父母不在的时候孩子也遇到很多的问题，回家以后一定花时间跟他们谈一谈今天作声么。	父母不在的时候孩子也遇到很多的问题，回家以后一定花时间跟他们谈一谈今天做什么。
春天有一点儿冷，可是很美，因为有很都不一样的花。	春天有一点儿冷，可是很美，因为有很多不一样的花。
以前工业大国－德国，他们重视工业，不管环憬保呼，然后不少人得了不明的病。	以前工业大国－德国，他们重视工业，不管环境保护，然后不少人得了不明的病。
我觉得要是你第一次告诉他会糊涂。肯能他你还说了半天，他的头还雾水。	我觉得要是你第一次告诉他会糊涂。可能他你还说了半天，他的头还雾水。
但是「教室里该不该装摄影机」这个议题不但只谈到技术的问题，而是牵涉到「人文道德」的领域了。	但是「教室里该不该装摄影机」这个议题不单只谈到技术的问题，而是牵涉到「人文道德」的领域了。
我妹妹想要个交相机和一对新楔子。	我妹妹想要个照相机和一对新鞋子。
在大学生的看法中，有人还把半工半读作为评选大学生能力的一个目标，意思是谁可以半工半读才是高手的！	在大学生的看法中，有人还把半工半读做为评选大学生能力的一个目标，意思是谁可以半工半读才是高手的！
这些年来跟您们的工厂住在同一区是让我们民主更有工作的发展，这一点我们感到非常感谢。	这些年来跟您们的工厂住在同一区是让我们邻居更有工作的发展，这一点我们感到非常感谢。
我觉得现代社会里当个家庭主妇时不太可能的。	我觉得现代社会里当个家庭主妇时不太可能的。
孩子先在也要上高中了吧，你还可以辅导他的学习。	孩子现在也要上高中了吧，你还可以辅导他的学习。
他从北投捷运站坐捷运到估停站。	他从北投捷运站坐捷运到古亭站。
如果影机是为了让家长只要在家里连上娜说学校的网站，就能看到小孩在教室里的情况。	如果影机是为了让家长只要在家里连上那所学校的网站，就能看到小孩在教室里的情况。
先在就读大学电子业的我，对未来想要的是发明新该念的汽车，目前已跟同学有一些计划研究。	现在就读大学电子业的我，对未来想要的是发明新概念的汽车，目前已跟同学有一些计划研究。
您的工厂开始运作到现在，影响不少到我们的生活，每天我们都会听到您工厂的操音，影响到小朋友的学习，老人的休息，让每个人天天为了这个操音而心理觉得很不舒服。	您的工厂开始运作到现在，影响不少到我们的生活，每天我们都会听到您工厂的噪音，影响到小朋友的学习，老人的休息，让每个人天天为了这个噪音而心里觉得很不舒服。
要是以自己赚得钱付学费的话，也许容易找到学习意义和学习价值。	要是以自己赚的钱付学费的话，也许容易找到学习意义和学习价值。
拿来我的经验来讲，因有经验而较快适应社会，也能干自己地工作。	拿来我的经验来讲，因有经验而较快适应社会，也能干自己的工作。
我想这次的危几未必不是一个很好的转机，你可以把握这个机会给自己充电。	我想这次的危机未必不是一个很好的转机，你可以把握这个机会给自己充电。
您可以把工厂搬到乡村外面，所以噪音不会印象我们（邻居），臭味也不会印象社会。	您可以把工厂搬到乡村外面，所以噪音不会影响我们（邻居），臭味也不会影响社会。
情爱的李大明。	亲爱的李大明。
我建议家长应该给自己的孩子们有了合适的上网时数，叫他们怎样利用好网路来学习，来增加自己的知识。	我建议家长应该给自己的孩子们有了合适的上网时数，教他们怎样利用好网路来学习，来增加自己的知识。
每位老师有自己的教惯，有的好友的不好。	每位老师有自己的教惯，有的好有的不好。
老师劝他和各位同学们，晚上不可以很晚回家，更可况要考试的时候，要认真念书。	老师劝他和各位同学们，晚上不可以很晚回家，更何况要考试的时候，要认真念书。
谢谢你，让我请待你的生日会，愉快地过时间，感谢。	谢谢你，让我期待你的生日会，愉快得过时间，感谢。
对这件的是父母很担心，可是他们也没有办法做什么，因为他们没有什么资料可以反对学校。	对这件的事父母很担心，可是他们也没有办法做什么，因为他们没有什么资料可以反对学校。
希望你门赶快处理，我也代表大家跟你说很不好意，因为我门没方法借收了，谢谢你。	希望你们赶快处理，我也代表大家跟你说很不好意，因为我们没方法接受了，谢谢你。
我相信，爸爸也希望我快快乐乐的过日子。	我相信，爸爸也希望我快快乐乐地过日子。
如果你拿到了请你奇给我一封简讯，还是打电话给我。	如果你拿到了请你寄给我一封简讯，还是打电话给我。
我没想到你们台南的公司的问题怎么大！我们台北的还好，因为我工作的时间还很正常。	我没想到你们台南的公司的问题这么大！我们台北的还好，因为我工作的时间还很正常。
如过有空，下一次我们再一起吃饭把！	如果有空，下一次我们再一起吃饭吧！
你道德地旁给我打电话。	你到的地方给我打电话。
你呢？希望你一切训利过的好。	你呢？希望你一切顺利过得好。
你的工厂影响到了我们的生活，因为你的工厂除了常出噪音之外，有时候还会有臭味，造成了我们过的生活都过得不正常。	你的工厂影响到了我们的生活，因为你的工厂除了产出噪音之外，有时候还会有臭味，造成了我们过的生活都过得不正常。
一辈子在家一直照顾孩子仗夫，然后辞掉你本来喜欢做的工作，这是现代的女人不能接受的生活。	一辈子在家一直照顾孩子丈夫，然后辞掉你本来喜欢做的工作，这是现代的女人不能接受的生活。
因为每个小孩的脾气不一样所以家长很担心有没有乖乖听老师的话有没有认真，小孩的成长一定要有家长在旁便教育。	因为每个小孩的脾气不一样所以家长很担心有没有乖乖听老师的话有没有认真，小孩的成长一定要有家长在旁边教育。
一遍他们喝醉了，一遍他们支持的棒球队也赢了。	一边他们喝醉了，一遍他们支持的棒球队也赢了。
如果在每个教室里装了摄影机的话，不相心老师的感觉也有。	如果在每个教室里装了摄影机的话，不相信老师的感觉也有。
由于近几周工厂之「噪音」及「臭味」极多的状况，令附近的住宅户感到不适，因此本人借由这封信希望厂长能够立刻出场处理。	由于近几周工厂之「噪音」及「臭味」极多的状况，令附近的住宅户感到不适，因此本人借由这封信希望厂长能够立刻出厂处理。
有了网路，我可以很快的捉住社会改变的情况，对世界的视野有了广泛的了解。	有了网路，我可以很快地捉住社会改变的情况，对世界的视野有了广泛的了解。
不要恐怕哪天我们家旁的环境，便到惨不忍赌的地步，被迫我们非搬家不可的。	不要恐怕哪天我们家旁的环境，变到惨不忍睹的地步，被迫我们非搬家不可的。
如果今天有什么功课我回去。我会跟同学惜来看。	如果今天有什么功课我回去。我会跟同学借来看。
政府和国民共同努力保乎台湾的自然。	政府和国民共同努力保护台湾的自然。
有时候我念书，有时候我听音龠。	有时候我念书，有时候我听音乐。
它看起来很葬，但是里面有很多照片让我纪念我的同学们。	它看起来很脏，但是里面有很多照片让我纪念我的同学们。
还有，你们工厂可以使用档声音的玻璃。那么声音与臭味不能传到外面，那一定是很好的办法。	还有，你们工厂可以使用挡声音的玻璃。那么声音与臭味不能传到外面，那一定是很好的办法。
星期的时候我下了可以后在图书馆念书。	星期的时候我下了课以后在图书馆念书。
虽然是有＂经济＂，可是又影响到生态环境，导致台湾持有的动值物可能因此消失，接下来旅客为此而不再来会导致台湾旅游业损失。	虽然是有＂经济＂，可是又影响到生态环境，导致台湾持有的动植物可能因此消失，接下来旅客为此而不再来会导致台湾旅游业损失。
利就是装摄影机后对一些家长来说是很好的办法，即可看到孩子上课人不认真、也可知道他有没有来学校上课、也可看到老师对孩子的态度是否适合老师的身分。	利就是装摄影机后对一些家长来说是很好的办法，既可看到孩子上课认不认真、也可知道他有没有来学校上课、也可看到老师对孩子的态度是否适合老师的身分。
事实上我们社会的坏色人很多。	事实上我们社会的坏的人很多。
我跟我女朋友在一起已经很就了。	我跟我女朋友在一起已经很久了。
真不烧得，下张项目可能为何？	真不晓得，下张项目可能为何？
如果装摄影机校长、老师、父母都可以看到学生做什么然后想一想怎么触犯孩子。	如果装摄影机校长、老师、父母都可以看到学生做什么然后想一想怎么处罚孩子。
所以有摄影机也一个方便很重要，让父母跟老师互教育小孩。	所以有摄影机有一个方便很重要，让父母跟老师互教育小孩。
我们住在同样的地方，也就算是亲戚的关奚了，您也不愿让自己的家人很困难的生活是吗？	我们住在同样的地方，也就算是亲戚的关系了，您也不愿让自己的家人很困难的生活是吗？
或著会宣称网路交友，因为对方无法确认你的身分，你就可以尽可能地扮演平常没有机会扮演角色。	或者会宣称网路交友，因为对方无法确认你的身分，你就可以尽可能地扮演平常没有机会扮演角色。
座下看菜单的时候，太可惜了，只有鱼可以吃了。	坐下看菜单的时候，太可惜了，只有鱼可以吃了。
上个星期我跟这里附近的人已经讨论这件事了，如果还这样下去，我们就不知道这么活下去了。	上个星期我跟这里附近的人已经讨论这件事了，如果还这样下去，我们就不知道怎么活下去了。
大家哪一天会集取在我们家生日好我们一起去看电影，逛街，把日常劳累放轻松号码？	大家那一天会集聚在我们家生日好我们一起去看电影，逛街，把日常劳累放轻松好吗？
虽然网路的发达，可以让我们掌握最新的资讯、生活圈变大、可以快速的获取资料，但是网络是个可怕的虚拟世界。	虽然网路的发达，可以让我们掌握最新的资讯、生活圈变大、可以快速地获取资料，但是网络是个可怕的虚拟世界。
我认为，对于外国学生难得来到异乡，就应该尽情的到户外去体验，这是多么可惜！	我认为，对于外国学生难得来到异乡，就应该尽情地到户外去体验，这是多么可惜！
可是对富翁们来讲没有很大的影响，影响都在平民跟老板性吧，这样使贫富差距更大。	可是对富翁们来讲没有很大的影响，影响都在平民跟老百姓吧，这样使贫富差距更大。
他住在忠孝新生捷运站的附近，他读书在师大所以他得坐捷运到台电大楼下车，走著走著就迷路了，他完全不知道他在哪哩。	他住在忠孝新生捷运站的附近，他读书在师大所以他得坐捷运到台电大楼下车，走著走著就迷路了，他完全不知道他在哪里。
他曾表示对经济、创业很有兴趣，故一定将踊跃的接受你的想法。	他曾表示对经济、创业很有兴趣，故一定将踊跃地接受你的想法。
他的眼靓的色红色，因为他现在很累，他要睡觉。	他的眼睛的色红色，因为他现在很累，他要睡觉。
整天一直有嗓音和臭味，他们即使在家里，也不能休息而甚么事都做不了。	整天一直有噪音和臭味，他们即使在家里，也不能休息而甚么事都做不了。
父母一起负责照顾孩子对孩子最有利、也对女人及整各式会最有利。	父母一起负责照顾孩子对孩子最有利、也对女人及整个社会最有利。
只有打算朋友之中过一段无忧无虑的时间，最重要的事让大家轻松一点。	只有打算朋友之中过一段无忧无虑的时间，最重要的是让大家轻松一点。
进大楼里面的时候，我再见面她，我很高心。	进大楼里面的时候，我再见面她，我很高兴。
我上高中的那时候，在我们班里，我跟一位同学间的关系不好。	我上高中的那时候，在我们班里，我跟一位同学间的关系不好。
可是涂然下雨很大，所以我们不能在外面。	可是突然下雨很大，所以我们不能在外面。
泥灰美国已后，请你帮我买一个好看黑色的表。	你回美国以后，请你帮我买一个好看黑色的表。
我也知道有些人觉得在网路上交朋友是种浪费时间又危险得行为。	我也知道有些人觉得在网路上交朋友是种浪费时间又危险的行为。
我们能做的就是更加努力的工作，更好的提高自己的能力，从而能在这样越来越激烈的斗争中继续保有自己的工作。	我们能做的就是更加努力地工作，更好地提高自己的能力，从而能在这样越来越激烈的斗争中继续保有自己的工作。
爸爸们高高兴兴的送孩子们到停车站。	爸爸们高高兴兴地送孩子们到停车站。
有许多西方国家的幼儿园已采取放任制度的教育，让孩童自由的探索这世界的奥妙和多变，并在适当或需要的时候给予辅助或指导。研究学者随后发现让孩童们学习的更多。	有许多西方国家的幼儿园已采取放任制度的教育，让孩童自由的探索这世界的奥妙和多变，并在适当或需要的时候给予辅助或指导。研究学者随后发现让孩童们学习的更多。
希望你能够参加我的生日会。玩的开心之后希望你的心情变得好一点。	希望你能够参加我的生日会。玩得开心之后希望你的心情变得好一点。
我当然想支持你，所以给你一些关于德国传统蔡的意见。	我当然想支持你，所以给你一些关于德国传统菜的意见。
先生每天辛苦地区工作，加班，赚薪水给家庭，他晚上下班回家的时候需要用心的老婆帮他。	先生每天辛苦地去工作，加班，赚薪水给家庭，他晚上下班回家的时候需要用心的老婆帮他。
王先生跟他说好多话，他们一直说话一直笑很开兴了！	王先生跟他说好多话，他们一直说话一直笑很开心了！
吃饭时因臭味而持不下饭，噪音也让我们睡不好造成了很多人生病。	吃饭时因臭味而吃不下饭，噪音也让我们睡不好造成了很多人生病。
应为网路只是我们生活中的一部分，不要太利用网路。	因为网路只是我们生活中的一部分，不要太利用网路。
其后，近来自从您方设置后，有许多区民对我反映，他们皆对您方的噪音以及臭味两方面表示不满意。	其后，近来自从您方设置后，有许多居民对我反映，他们皆对您方的噪音以及臭味两方面表示不满意。
反正在摆路边摊的人之中，百分之七十有学士学位，有些甚至还有硕士或博士学位，这个现象已经算很普骗了。	反正在摆路边摊的人之中，百分之七十有学士学位，有些甚至还有硕士或博士学位，这个现象已经算很普遍了。
我也知道老师很生气，因为我常常赤道。	我也知道老师很生气，因为我常常迟到。
我要买一个太样兵，因为这个是台湾的传通饼干。	我要买一个太阳饼，因为这个是台湾的传统饼干。
当然老师没有办法看还有骂这样的每个学生，可是如果这样的学生知道老师再录影考试，他们一定不会敢麻烦用功的学生。	当然老师没有办法看还有骂这样的每个学生，可是如果这样的学生知道老师在录影考试，他们一定不会敢麻烦用功的学生。
他不座我们计程车而先用台语告诉司机他叔叔地址而用英文跟我们说不必担心，司机知道。	他不坐我们计程车而先用台语告诉司机他叔叔地址而用英文跟我们说不必担心，司机知道。
政府应补贴有需的家庭，让其孩子有机会去托儿所。	政府应补贴有需的家庭，让其孩子有机会去托儿所。
我真得很同情你，亏钱也跟同学变关系，真是无奈。	我真的很同情你，亏钱也跟同学变关系，真是无奈。
我门住在地球，从古代到现在，我门应该饮水思原。	我们住在地球，从古代到现在，我门应该饮水思源。
我们这计划是研发太阳能的汽车，先在已到一个段落，未会跟同学一规划，一起合作开一家公司关于这各方面，希望您能了解！	我们这计划是研发太阳能的汽车，现在已到一个段落，未会跟同学一规划，一起合作开一家公司关于这个方面，希望您能了解！
台湾生活让他打开眼镜知道很多别的国家的社会事情，很真得。	台湾生活让他打开眼镜知道很多别的国家的社会事情，很值得。
我同一现在全球经济危机影像到每个人，还好我们有工作呢。	我同意现在全球经济危机影响到每个人，还好我们有工作呢。
虽然在教室里装摄影机可以让家长看到小孩在教室里的情，使他们放心，不过，这种作法实在是太极端了吧！	虽然在教室里装摄影机可以让家长看到小孩在教室里的情，使他们放心，不过，这种做法实在是太极端了吧！
今天他很早就起来，因为他不知道学校在那里？	今天他很早就起来，因为他不知道学校在哪里？
我今天找老师，但是老是不在。	我今天找老师，但是老师不在。
我跟我的风友学中文。	我跟我的朋友学中文。
希望你们赞成这位校长的作法。	希望你们赞成这位校长的做法。
李大名坐公车的时候，又一边睡觉有又一边很快的看书，因为晚上没有看书。	李大明坐公车的时候，又一边睡觉有又一边很快的看书，因为晚上没有看书。
好就我们没看见，所以很高兴。	好久我们没看见，所以很高兴。
我来大开门乱讲，老师更生气了，因为今天是考试。	我来打开门乱讲，老师更生气了，因为今天是考试。
下个星期我想你跟我一起去一家非常有名的饭店，如果我们在饭店外面吃，我们可以看到一个漂漂亮亮地风景。	下个星期我想你跟我一起去一家非常有名的饭店，如果我们在饭店外面吃，我们可以看到一个漂漂亮亮的风景。
我想请假一天，候天我一定会来上课的。	我想请假一天，后天我一定会来上课的。
而且，同学说我拿他的钱包的时候，真得很生气。	而且，同学说我拿他的钱包的时候，真的很生气。
他们吃了完絣干，也喝了完啤酒。	他们吃了完饼干，也喝了完啤酒。
现代的事会而言，大家都很忙，丈夫与妻子各有工作。	现代的社会而言，大家都很忙，丈夫与妻子各有工作。
对我来说，支持孩子长大、变成可考的大人的一部分是让孩子学独立、让他们发现自己的爱好。	对我来说，支持孩子长大、变成可靠的大人的一部分是让孩子学独立、让他们发现自己的爱好。
受到你的信自己觉得李大年真是太过分了！虽然我跟他不熟，可能不太了解他的个性，但是不管如何，这样的行为太离普了。	收到你的信自己觉得李大年真是太过分了！虽然我跟他不熟，可能不太了解他的个性，但是不管如何，这样的行为太离谱了。
但有些人是没有打工还玩的嘻嘻哈哈，也有些人是打工到半夜，回到家还认真读书、预习或复习。	但有些人是没有打工还玩得嘻嘻哈哈，也有些人是打工到半夜，回到家还认真读书、预习或复习。
春天的时候开花，什么地方都录了。	春天的时候开花，什么地方都绿了。
因为你们的公厂有味道和声音太大，邻有反因，希望你们赶快处理。	因为你们的工厂有味道和声音太大，邻有反应，希望你们赶快处理。
我都很认真的听和说出自己的意见并且也很严肃地思考及分析那个意见是好的或是不好的。	我都很认真地听和说出自己的意见并且也很严肃地思考及分析那个意见是好的或是不好的。
我住在台北已经一年了，而接学中文在师大的中文中心的。	我住在台北已经一年了，而且学中文在师大的中文中心的。
第二状况为原本很干净的乡村开始有臭味，我们不太明白，为什么柜公司会出来臭味呢？	第二状况为原本很干净的乡村开始有臭味，我们不太明白，为什么贵公司会出来臭味呢？
我没有办法养它，决定送给朋友。我的环境也部适合养狗。	我没有办法养它，决定送给朋友。我的环境也不适合养狗。
最近我们觉得你们工厂的味道很不舒服，还有很吵，晚上不难睡觉越了越我们家的人不好的。	最近我们觉得你们工厂的味道很不舒服，还有很吵，晚上不能睡觉越来越我们家的人不好的。
我要帮助台湾人，多一点认是圣经。	我要帮助台湾人，多一点认识圣经。
小小说她很想跟他一起看电影，可是她有很多功课她还没作所以她的父母今天可能不被她出去。	小小说她很想跟他一起看电影，可是她有很多功课她还没做所以她的父母今天可能不被她出去。
我受到你寄给我的信。最近全球经济不景气，大家都受到这个影响。	我收到你寄给我的信。最近全球经济不景气，大家都受到这个影响。
有人说，世界上的事情的黑白分不了，没个方法都有所导理。	有人说，世界上的事情的黑白分不了，每个方法都有所道理。
因为他喝了很多酒，晚一点回家，所以今天早上睡过偷了。	因为他喝了很多酒，晚一点回家，所以今天早上睡过头了。
前天我在学校公园看书，不小心把输给弄丢了。	前天我在学校公园看书，不小心把书给弄丢了。
我很系望原谅，握祝你跟同学出去好好玩儿，你跟同学玩的人快乐，记得要小心。	我很希望原谅，我祝你跟同学出去好好玩儿，你跟同学玩的人快乐，记得要小心。
这时候他问别人：「现在机点？」	这时候他问别人：「现在几点？」
在补习班他昨天晚上到夜里两点才读书，所以他一回家就累得睡觉了。	在补习班他昨天晚上到夜里两点才读书，所以他一回家就累得睡觉了。
等五分钟他的老是就近来，大明跟他的老师很高兴，因为它的老师是在路上大明问的小姐。	等五分钟他的老师就进来，大明跟他的老师很高兴，因为他的老师是在路上大明问的小姐。
我认识越多人宁可选交友网站来找男奴朋友不是去酒吧或ＤＩＳＣＯ。	我认识越多人宁可选交友网站来找男女朋友不是去酒吧或ＤＩＳＣＯ。
即然我要跟你见面，可是应该帮他，可不可以改天吗？	既然我要跟你见面，可是应该帮他，可不可以改天吗？
后来等以等公车也来了。	后来等一等公车也来了。
纸呢身体健康。	祝你身体健康。
因为他们有传业的，会把你的孩子教得好。但你也要跟老师们配合，一起关心小孩的程度、情绪等等，才是好方法的教育。	因为他们有专业的，会把你的孩子教得好。但你也要跟老师们配合，一起关心小孩的程度、情绪等等，才是好方法的教育。
网路上可以学习，可是只用一些，可以不要乱用，这样不会影到他的文化。	网路上可以学习，可是只用一些，可以不要乱用，这样不会引导他的文化。
他很快去里面开冰箱，他拿一般饼干，根几杯可乐去客厅吃。	他很快去里面开冰箱，他拿一盘饼干，跟几杯可乐去客厅吃。
对我来说，这个是一个好的方法，很适合住在大成市的人。	对我来说，这个是一个好的方法，很适合住在大城市的人。
在路上有很多人，非常热恼。	在路上有很多人，非常热闹。
从你的工厂移来这儿起我们收到不少噪音和臭味的影响，每天你们工厂都上班而且上到很晚。	从你的工厂移来这儿起我们受到不少噪音和臭味的影响，每天你们工厂都上班而且上到很晚。
他要去中文壳可是不怎到哪里。	他要去中文课可是不怎到哪里。
例如您可以改营业时间提早一点，这样晚上您可以早一点休息，而且我们儿子们就能著睡。	例如您可以改营业时间提早一点，这样晚上您可以早一点休息，而且我们儿子们就能早睡。
然后他试试看用英文问一个台湾的小姐，很辛亏她听得懂英文。	然后他试试看用英文问一个台湾的小姐，很幸亏她听得懂英文。
下了课我昨天在学校的门口事等我女朋友的，她叫美美。	下了课我昨天在学校的门口是等我女朋友的，她叫美美。
我得座火车回家去，可是火车站远得不得了，我怕我走不到。	我得坐火车回家去，可是火车站远得不得了，我怕我走不到。
如果你们就不处理噪音和臭味的问题，我们需要跟政府人员联络，在法院开始搞你们的公司。	如果你们就不处理噪音和臭味的问题，我们需要跟政府人员联络，在法院开始告你们的公司。
怎么帮？我觉得这个法文的问题很难。	怎么办？我觉得这个法文的问题很难。
我想他之所以这样做也是因了家长们著想的。	我想他之所以这样做也是应了家长们著想的。
象片儿里面有三张椅子。	相片儿里面有三张椅子。
爸爸有喜欢的，我也有喜欢的，我根本一点都没兴趣，要做这些事，但被你必我做，然后对你公司有影响，这样岂不是白做吗？	爸爸有喜欢的，我也有喜欢的，我根本一点都没兴趣，要做这些事，但被你逼我做，然后对你公司有影响，这样岂不是白做吗？
我要毕业以后不要在读书、要找工作。	我要毕业以后不要再读书、要找工作。
我知道了，以前你没工作的时候兴起不好。	我知道了，以前你没工作的时候心情不好。
虽然对我来说太大而不是很方便，但总比冷死好。就这样那个棉被默默的用到现在了。	虽然对我来说太大而不是很方便，但总比冷死好。就这样那个棉被默默地用到现在了。
我只是好心的帮她带过来而已，还被她说成这样耶！	我只是好心地帮她带过来而已，还被她说成这样耶！
考试我要先听老师交代贵定，我很用心努力考试。	考试我要先听老师交代规定，我很用心努力考试。
要试探不成我们就比用行动来表达自己的意见楼。	要是谈不成我们就比用行动来表达自己的意见啰。
回拨兰的时候会向台湾朋友和台湾漂亮的风景像阿里山、海边、台湾的水果和漂亮的衣服。	回波兰的时候会向台湾朋友和台湾漂亮的风景像阿里山、海边、台湾的水果和漂亮的衣服。
比如说，减小您们工厂的工作时间、或买新的设备比较小造成臭味跟大声等等。	比如说，减少您们工厂的工作时间、或买新的设备比较少造成臭味跟大声等等。
父母理由任何的方法保证孩子的安全	父母利用任何的方法保证孩子的安全
我考完试以后、再庆祝一次把！	我考完试以后、再庆祝一次吧！
我觉得正在挑战的你的样子很美丽。有信心地面对吧。	我觉得正在挑战的妳的样子很美丽。有信心地面对吧。
只要装钱就大家都吃得饱、穿得暖就好了，就算父母。	只要赚钱就大家都吃得饱、穿得暖就好了，就算父母。
其次，青少年的自我约束能力较低，所以应该有父母加以限制。	其次，青少年的自我约束能力较低，所以应该由父母加以限制。
每个国家友好的和不好的人，所以你们上网的时候当然也会碰到好的和不好的人。	每个国家有好的和不好的人，所以你们上网的时候当然也会碰到好的和不好的人。
不要太难过了，反正通过这件是大家都知道你是怎么样的，这对你也不是很好吗？	不要太难过了，反正通过这件事大家都知道你是怎么样的，这对你也不是很好吗？
父母自然而然地给学生一些零用钱，但是通常考卢不到现代的价钱跟他们读书时候的价钱不太一样。	父母自然而然地给学生一些零用钱，但是通常考虑不到现代的价钱跟他们读书时候的价钱不太一样。
小美好像是拟越来越漂亮了。	小美好像是妳越来越漂亮了。
我们认为工厂的还清又干净又健康会对工厂有好的影响。所以我们会一起互相合作。	我们认为工厂的环境又干净又健康会对工厂有好的影响。所以我们会一起互相合作。
希望你们那个很特别的一天过的很开心！	希望你们那个很特别的一天过得很开心！
听说你的其末考已经考完了，你有没有时间跟我一起去吃饭？	听说你的期末考已经考完了，你有没有时间跟我一起去吃饭？
我想向您回报我家最进的可怖遭遇，事情涉及到我们本市民众的饮食安全所以我相信您作为卫生部门的负责人会对此有兴趣。	我想向您回报我家最近的可怖遭遇，事情涉及到我们本市民众的饮食安全所以我相信您作为卫生部门的负责人会对此有兴趣。
不过有一些学生不太喜欢念书不但没做功课还跳课、有一些老师常常很容易生气不但骂学生还打学生。	不过有一些学生不太喜欢念书不但没做功课还翘课、有一些老师常常很容易生气不但骂学生还打学生。
下礼拜五下午十二点十分在学校大们口见面！	下礼拜五下午十二点十分在学校大门口见面！
如果他们的血压就越来越高，没办法拿到健康的程度。	如果他们的血压就越来越高，没办法达到健康的程度。
早上做公车去山上，到了以后，我们就马上开始做饭。	早上坐公车去山上，到了以后，我们就马上开始做饭。
第四个象片儿：两个人都看点影。	第四个相片儿：两个人都看电影。
可是我刚刚来的留学生，所以我不智道学校在那儿。	可是我刚刚来的留学生，所以我不知道学校在那儿。
那话说回来在研究所念书的学生都是找不到工作，才升学了马？并不一定。	那话说回来在研究所念书的学生都是找不到工作，才升学了吗？并不一定。
因为这次出国处出差太忙了，都没有时间去买礼物给他门。	因为这次出国处出差太忙了，都没有时间去买礼物给他们。
小明的女朋友觉得这个电影很有趣，他觉得这个电影里的人都很可爱。可是下明觉得有一点长，那么长他睡著了。	小明的女朋友觉得这个电影很有趣，他觉得这个电影里的人都很可爱。可是小明觉得有一点长，那么长他睡著了。
上课时总不能专心，因为会觉得有很多眼睛在登著我。	上课时总不能专心，因为会觉得有很多眼睛在瞪著我。
要是有钱的话、应该用为了别的事：比如说，校院里盖新的玩具等等。	要是有钱的话、应该用为了别的事：比如说，校园里盖新的玩具等等。
我们日本人要用营养的食物来补重体力的时候，常吃这个菜。	我们日本人要用营养的食物来补充体力的时候，常吃这个菜。
我就是希望社会安排多多级层的工作机会，余假活动。	我就是希望社会安排多多级层的工作机会，余暇活动。
我们只好先过著这样的生活，等到经济恢复，我们就可以过著跟已前一样的生活。	我们只好先过著这样的生活，等到经济恢复，我们就可以过著跟以前一样的生活。
听所学校隔壁那家法国餐厅不错也不太贵，你吃过吗？	听说学校隔壁那家法国餐厅不错也不太贵，你吃过吗？
救我的想法呢，我可能也会很难过吧但是我也会让她找在我书包，先让他不会继续怀疑我然后帮她找回来看看他那时会对我怎样。	就我的想法呢，我可能也会很难过吧但是我也会让她找在我书包，先让他不会继续怀疑我然后帮她找回来看看他那时会对我怎样。
其中一个，是摄影机。它主要的应用就是观察共用场所为了确保社会安全。	其中一个，是摄影机。它主要的应用就是观察公用场所为了确保社会安全。
我心理含著喷奴而写此书，为了大家后来的饮食安全问题，我特去此信向您汇报一下。	我心里含著愤怒而写此书，为了大家后来的饮食安全问题，我特去此信向您汇报一下。
她回到家她九打电话给他的好久不见的好朋友。	她回到家她就打电话给他的好久不见的好朋友。
她是重美国留学回来的。	她是从美国留学回来的。
比如说它们支持各方面的学问、但现在他们愿意比业这大学校以后、赶快找工作比别的大学。	比如说它们支持各方面的学问、但现在他们愿意毕业这大学校以后、赶快找工作比别的大学。
我认为小孩子尽早开始他们的正规教育有助于小孩子个性方面会没那么挑皮，比较会听话的。	我认为小孩子尽早开始他们的正规教育有助于小孩子个性方面会没那么调皮，比较会听话的。
大明告诉她他要去学校可是他不局道在那里。	大明告诉她他要去学校可是他不知道在那里。
我们也会跟媒体联络（如：苹果报纸、台视等等），请他们来检查这个问题，就报到民众。	我们也会跟媒体联络（如：苹果报纸、台视等等），请他们来检查这个问题，就报导民众。
我们坐了三十分钟车交到了。	我们坐了三十分钟车就到了。
你有听过个小朋友从爸爸的胸部的到东西吃吗？你还是觉得这个时候去强迫女人去念书上班算是男女公平的看法吗？	你有听过个小朋友从爸爸的胸部得到东西吃吗？你还是觉得这个时候去强迫女人去念书上班算是男女公平的看法吗？
我也是你的朋有，我会永远在你身边。	我也是你的朋友，我会永远在你身边。
春天跟秋天都很舒服，可是冬天件或太冷。	春天跟秋天都很舒服，可是冬天间或太冷。
如果李工厂不处理的话，是很严重的是，我们会去市议会告诉市议员这个问题。	如果李工厂不处理的话，是很严重的事，我们会去市议会告诉市议员这个问题。
里先生，我们在这每天都要做生意，客人往来很多。	李先生，我们在这每天都要做生意，客人往来很多。
装摄影机主要目的是维护教室环境的安全、保护每个学校的成员的权力、及帮忙提申学生的学习品质。	装摄影机主要目的是维护教室环境的安全、保护每个学校的成员的权利、及帮忙提升学生的学习品质。
建立一条公路事带给住在那里的人多少的利益呢？那个是完全的吗？那个是永远的吗？	建立一条公路是带给住在那里的人多少的利益呢？那个是完全的吗？那个是永远的吗？
不能买卖而必说到出租呢？很多人会想要用所有的机会来赚钱，但是利用人或动物的感情来作生意是不对的。	不能买卖何必说到出租呢？很多人会想要用所有的机会来赚钱，但是利用人或动物的感情来做生意是不对的。
这个臭气常常进入我们的食品也会产生不同疾病的原因，几天前我们发现我们地区的小鸟是因为每天闻到工厂的臭气而慢慢死掉。贵公司工场造出的噪音也变成一个沉甸甸的问题。	这个臭气常常进入我们的食品业会产生不同疾病的原因，几天前我们发现我们地区的小鸟是因为每天闻到工厂的臭气而慢慢死掉。贵公司工厂造出的噪音也变成一个沉甸甸的问题。
我们自己觉得很幸福，所以我门不想回国。	我们自己觉得很幸福，所以我们不想回国。
因为如果你们的展品让我们的身体有问题我们一定不会支持你们，所以我们希望你们能处理你们工厂的噪音和臭味。	因为如果你们的产品让我们的身体有问题我们一定不会支持你们，所以我们希望你们能处理你们工厂的噪音和臭味。
他有两个孩子，男生还有努生。	他有两个孩子，男生还有女生。
很高兴听到你的消息。应为我们好像很久没有联络。	很高兴听到你的消息。因为我们好像很久没有联络。
我跟我泰泰都惜欢。	我跟我太太都喜欢。
那天他高心的没说话，所以她决定下个礼拜请我去他的家玩。	那天他高兴的没说话，所以她决定下个礼拜请我去他的家玩。
大年受到你帮他买了东西以后，一定很高兴	大年收到你帮他买了东西以后，一定很高兴
因为最近我不舒服，我想去看医生，所以我明天不难去上课。	因为最近我不舒服，我想去看医生，所以我明天不能去上课。
他们都很喜欢看唷意思的电影。	他们都很喜欢看有意思的电影。
你可以吃我们最有名的采，一定很好玩。	你可以吃我们最有名的菜，一定很好玩。
如果那份工作经验是为了为生，休养的成分也削弱，精神分散。	如果那份工作经验是为了为生，修养的成分也削弱，精神分散。
可以在一次看那个小姐，德伟佷高兴了。	可以再一次看那个小姐，德伟佷高兴了。
话说回来我采网路家的朋友大部分只跟我说一说几天，然后结束跟我连啰。	话说回来我在网路交的朋友大部分只跟我说一说几天，然后结束跟我连络。
开车的先生吧窗户开开。	开车的先生把窗户开开。
然后巴士来了，他们很高兴得近去。	然后巴士来了，他们很高兴地进去。
所以我建议你不论如何在离开他远一点比较好，哪些书如果他真的不要的话你可以去问你的老师或其他同学，一定会有人想要的。	所以我建议你不论如何再离开他远一点比较好，那些书如果他真的不要的话你可以去问你的老师或其他同学，一定会有人想要的。
要是还想赚更多钱，周末的时候也可以工作。	要是还想赚更多钱，周末的时候也可以工作。
在一些大城市的年轻人，他们比较有优势的接触到新的科技，学习的机会也增加多了。	在一些大城市的年轻人，他们比较有优势地接触到新的科技，学习的机会也增加多了。
你们要结婚那天我很忙，那天我要去烤师。	你们要结婚那天我很忙，那天我要去考试。
张大林是一个很好的学生，他又用功又聪明。他常常帮别的学生的芒。	张大林是一个很好的学生，他又用功又聪明。他常常帮别的学生的忙。
因为后天我有靠事，所以我要看书。	因为后天我有考试，所以我要看书。
可是并不合适放在助中还是高中因为那些学生的年纪已经大了，不太好如果学校太多控制他们。	可是并不合适放在初中还是高中因为那些学生的年纪已经大了，不太好如果学校太多控制他们。
例如机器的问题还是工厂场内的、看哪个地方需要改进、要不要把墙壁修好、让声音不能出去、就不会影响到别人了。	例如机器的问题还是工厂厂内的、看哪个地方需要改进、要不要把墙壁修好、让声音不能出去、就不会影响到别人了。
我们家隔壁的林小姐，她刚刚生产了一个小宝贝，她才三个月大、可是每天睡不叫，以睡就醒起来，每天都睡不饱。	我们家隔壁的林小姐，她刚刚生产了一个小宝贝，她才三个月大、可是每天睡不觉，一睡就醒起来，每天都睡不饱。
科技高度发达的现在，电脑已经不再是新鲜地工具了。	科技高度发达的现在，电脑已经不再是新鲜的工具了。
有一天林小安去爬山，因为听说风京很漂亮。	有一天林小安去爬山，因为听说风景很漂亮。
首先请客位读者自己想像自己为这所小学的学生。	首先请各位读者自己想像自己为这所小学的学生。
可惜我不能参加，因为现在我正在台南念研究所，还有明天跟后天我得考其末考了。	可惜我不能参加，因为现在我正在台南念研究所，还有明天跟后天我得考期末考了。
吃了饭，我们的衣服都感。	吃了饭，我们的衣服都干。
部是指人类有心或感情，它们也会感到欢乐、也会感到悲哀。	不是只人类有心或感情，它们也会感到欢乐、也会感到悲哀。
明天我要跟我得妈妈去公司买些重要得东西，所以不能跟你一块儿去。	明天我要跟我得妈妈去公司买些重要的东西，所以不能跟你一块儿去。
你应该多喝水，热水就属最好的，也多吃水果。	你应该多喝水，热水就是最好的，也多吃水果。
我下次回家的时候一定会清他，清清楚楚的写下来一些蔡的做法，好不好？	我下次回家的时候一定会请他，清清楚楚的写下来一些菜的做法，好不好？
爸爸我想升学年博士年外交系，而如果我成功的话我将会是我们家的第一位年到博士的学位。	爸爸我想升学念博士念外交系，而如果我成功的话我将会是我们家的第一位念到博士的学位。
每天我们不舒服，不能睡觉，吃饭也吃得不下，因为很大的生音和臭味对的影响。	每天我们不舒服，不能睡觉，吃饭也吃得不下，因为很大的声音和臭味对的影响。
你最近好码？妈妈告诉我你的生意好像不错。	你最近好吗？妈妈告诉我你的生意好像不错。
我们区民皆同意由于您方所造成他们的噪音困扰大致上分为两个时段。	我们居民皆同意由于您方所造成他们的噪音困扰大致上分为两个时段。
你别再难过，你跟我一样要相信别人喝社会的人嘛！	你别再难过，你跟我一样要相信别人和社会的人嘛！
结果，他决定要是下一次去爬上，跟朋友一起去比较好。	结果，他决定要是下一次去爬山，跟朋友一起去比较好。
好久没间，还没问你最近去那里现在才回来，都没跟我联络呢。	好久没见，还没问你最近去哪里现在才回来，都没跟我联络呢。
表面上是天灾，但是追根究底来研究就是我们低球环境热化而造成的。	表面上是天灾，但是追根究底来研究就是我们地球环境热化而造成的。
目前应该改变社会里的观念而环境。	目前应该改变社会里的观念和环境。
图书馆没有门票也不用附那边的电费，有那么多空的话就去那边看书可以得到很多很多知识。	图书馆没有门票也不用付那边的电费，有那么多空的话就去那边看书可以得到很多很多知识。
我最喜欢秋天山上的风镜。	我最喜欢秋天山上的风景。
大明你还记不记得我们的阿兰女同学？	大明你还记不记得我们的荷兰女同学？
针对某一所私立小学校长提出的「教室里该不该装影机」，我的看法是不参成。	针对某一所私立小学校长提出的「教室里该不该装影机」，我的看法是不赞成。
汽车停车，然后他过去汽车要问男生原意送他到台北火车站去。	汽车停车，然后他过去汽车要问男生愿意送他到台北火车站去。
有可能如同你说的一般，只因为你座在他的旁边，所以他没有想很多，就疑惑是不是你。	有可能如同你说的一般，只因为你坐在他的旁边，所以他没有想很多，就疑惑是不是你。
因为又大声音又臭味，所以我们不知道什么告诉你我们的问题。	因为又大声音又臭味，所以我们不知道怎么告诉你我们的问题。
小时候常常可以从早上，不吃不喝的一直坐在电脑前面到晚上。	小时候常常可以从早上，不吃不喝地一直坐在电脑前面到晚上。
你带你的昭显机呢，得不忘了。	你带你的照相机呢，得不忘了。
在安卡拉我最喜暗的季节是秋天。	在安卡拉我最喜欢的季节是秋天。
要是你太忙没关系！我总是请你吃饭。	要是你太忙没关系！我总是请你吃饭。
我老婆的公司上礼拜也破产了，她现在也没有工作了，只好在家照顾小孩。在这样的情况下让我授到更大的压力。	我老婆的公司上礼拜也破产了，她现在也没有工作了，只好在家照顾小孩。在这样的情况下让我受到更大的压力。
我妈妈至少有他的职业。他有机会念书，有赚钱的能力。	我妈妈至少有她的职业。她有机会念书，有赚钱的能力。
我跟你相处了哪么久，当然知道你的中文很好。	我跟你相处了那么久，当然知道你的中文很好。
今天下了课，我打算跟我的奴朋友去看电影，所以我有一点儿领张，六点半我就起床了。	今天下了课，我打算跟我的女朋友去看电影，所以我有一点儿紧张，六点半我就起床了。
脸色跟样子是随便都可以，麻烦你喔！	颜色跟样子是随便都可以，麻烦你喔！
附近有一家超级市场，对们有一个书店。	附近有一家超级市场，对门有一个书店。
其实自从有了网路，生活上非常的方便，我们可以知道与了解很多知讯。	其实自从有了网路，生活上非常地方便，我们可以知道与了解很多资讯。
出你：万事如意，身体健康。	祝你：万事如意，身体健康。
往前就一台车开过来，把林小安歹去车帐。	往前就一台车开过来，把林小安带去车站。
最求自己的利益而已，而不再在乎人品，人文，以及道德？	追求自己的利益而已，而不再在乎人品，人文，以及道德？
接者因为民众晚上十点之后希望能够有安静既舒适的睡眠时间，本人也得知贵工厂是裁二十四小时轮班运作方式，你们在这里开工厂已经有很长的一段时间。	接著因为民众晚上十点之后希望能够有安静及舒适的睡眠时间，本人也得知贵工厂是采二十四小时轮班运作方式，你们在这里开工厂已经有很长的一段时间。
我觉得现代的孩子迷上的东西比我小孩是更多，所以我觉得用摄影机观察他们的行为是对的。	我觉得现代的孩子迷上的东西比我小孩时更多，所以我觉得用摄影机观察他们的行为是对的。
我们还要求您工厂借由与我们商量再指定工作时间机其他规定，譬如；早上或晚上特定时间内勿启动造出噪音的机器。	我们还要求您工厂借由与我们商量在指定工作时间及其他规定，譬如；早上或晚上特定时间内勿启动造出噪音的机器。
您好李佬时，今天我找您。	您好李老师，今天我找您。
今天在上课学到最难得课，我跟别的同学也觉得本来是这样，我的同学不太懂，正好我昨天刚才念这个问题，所以把他不懂的问题再教给他。	今天在上课学到最难的课，我跟别的同学也觉得本来是这样，我的同学不太懂，正好我昨天刚才念这个问题，所以把他不懂的问题再教给他。
从那时候我发现画愈好不仅是书面知识而已，华语好还要接触很多生活的经验。	从那时候我发现华语好不仅是书面知识而已，华语好还要接触很多生活的经验。
一方面我以竟有很多很棒的朋友所以有的时候我很烂跟他们连络约时间。	一方面我已经有很多很棒的朋友所以有的时候我很懒跟他们连络约时间。
但您知不知道，咱们家里的人，承受您的天付才能只有大哥。	但您知不知道，咱们家里的人，承受您的天赋才能只有大哥。
然后那个外国学生马上去市大学校学中文。	然后那个外国学生马上去师大学校学中文。
你的身体号码？	你的身体好吗？
现在，全球经济衰退所遗裁员、无薪假等的事请都是常见。	现在，全球经济衰退所以裁员、无薪假等的事情都是常见。
你们最近正么样？我们希望妳的家人都平安和顺利。	你们最近怎么样？我们希望妳的家人都平安和顺利。
对眼睛来说一直看荧幕很久的时间是以个不好的动作。有的人由于是因为看太久和太进而戴眼镜。	对眼睛来说一直看荧幕很久的时间是一个不好的动作。有的人由于是因为看太久和太近而戴眼镜。
有一次我的室友叫我帮他买笔记电脑，我就帮他买回到宿舍，果然他就说没有叫我买，那时后我真的很生气他。	有一次我的室友叫我帮他买笔记电脑，我就帮他买回到宿舍，果然他就说没有叫我买，那时候我真的很生气他。
可是我不拘导什么买。请你帮我！	可是我不知道什么买。请你帮我！
买了宠物之后，他们觉得太麻烦，尤其去旅行的时候，带它去玩很麻烦，有些人因有这样的原因而把自己养的狗或著猫丢掉。	买了宠物之后，他们觉得太麻烦，尤其去旅行的时候，带它去玩很麻烦，有些人因有这样的原因而把自己养的狗或者猫丢掉。
在学校因为他很用功常常坐最前面的椅子。	在学校因为他很用功常常坐最前面的椅子。
除了两个礼拜上班以外我都在夜市做生意，夏天的时候我买一下饮料，可是这几天冬天就来了，所以我已经换过买一些热的甜汤。	除了两个礼拜上班以外我都在夜市做生意，夏天的时候我卖一下饮料，可是这几天冬天就来了，所以我已经换过卖一些热的甜汤。
虽然会有人说这样子的话简直把猫狗变成玩具，玩玩了就不要了，我可不这么认为。	虽然会有人说这样子的话简直把猫狗变成玩具，玩完了就不要了，我可不这么认为。
所以家长不但要限止小孩上网时数，也要多多关心他们，还要灌输正确的观念给他们，因为网路无所不在。	所以家长不但要限制小孩上网时数，也要多多关心他们，还要灌输正确的观念给他们，因为网路无所不在。
厅说，你要回国星期一。我来你的宿校，可是我找不到你，所以我留一条信。	听说，你要回国星期一。我来你的宿舍，可是我找不到你，所以我留一条信。
现代的教育要跟著工业时代而有很大的转变。列如是老师不可以打骂学生，或是装摄影机等等。	现代的教育要跟著工业时代而有很大的转变。例如是老师不可以打骂学生，或是装摄影机等等。
我今天来找你的时候你不再，我想告诉你，我明天不能来上课。	我今天来找你的时候你不在，我想告诉你，我明天不能来上课。
只要逛一逛就碰到德国蔡其中的特色	只要逛一逛就碰到德国菜其中的特色
我们会有单心和问题。要不然我们会告诉市长，让他帮忙。	我们会有担心和问题。要不然我们会告诉市长，让他帮忙。
由之可见，在教室里装摄影机的坏处比好处比较多。	由此可见，在教室里装摄影机的坏处比好处比较多。
我的生日那天，我没有邀请太多的人。我们可以开心的庆祝好之后，就一起来规划我们的未来。	我的生日那天，我没有邀请太多的人。我们可以开心地庆祝好之后，就一起来规划我们的未来。
有一天他问我朋友的手机号码，我的朋友可以告诉他号吗因为相信他。	有一天他问我朋友的手机号码，我的朋友可以告诉他号码因为相信他。
应为很乐他忘记设定闹钟，早上７：３０才起来。	因为很累他忘记设定闹钟，早上７：３０才起来。
可是我现在有自已的人生计划，我没有办法受到这么大的压力了。	可是我现在有自己的人生计划，我没有办法受到这么大的压力了。
美美说应为学校没有冷气，所以今天教室里面热得不得了。	美美说因为学校没有冷气，所以今天教室里面热得不得了。
快快从家跑步到公车站等公车，因为他悾怕迟到了老师会生气。	快快从家跑步到公车站等公车，因为他恐怕迟到了老师会生气。
教育是一股热门的话题，每个时代都很关心它。为怎么呢？这是一代连一代很重要的关节。	教育是一股热门的话题，每个时代都很关心它。为什么呢？这是一代连一代很重要的关节。
送优秀的孩子去念名校，家庭都要孩子们读以后可以赚多点儿钱的系，譬如医、法律、会计、经济、财务等。	送优秀的孩子去念名校，家庭都要孩子们读以后可以赚多点儿钱的系，譬如医、法律、会计、经济、财务等。
因为表哥说现在他遇到的问题是一个大考验，所以他应该必须很正面地面对这个大考验以及不断的努力去解决它。	因为表哥说现在他遇到的问题是一个大考验，所以他应该必须很正面地面对这个大考验以及不断地努力去解决它。
因为，发达国家都经过工业革命，然后他门自身感受到自然坡坏的后果。	因为，发达国家都经过工业革命，然后他们自身感受到自然破坏的后果。
我有很多领据工作在李工厂，这家工厂帮这个城市的经济。	我有很多邻居工作在李工厂，这家工厂帮这个城市的经济。
另外、年纪大的人也很烦因为噪音害他们没办法睡得好，除了工厂的噪音意外，还有臭味。	另外、年纪大的人也很烦因为噪音害他们没办法睡得好，除了工厂的噪音以外，还有臭味。
我打算去餐厅买牛肉，可是我不知道去哪里买，我听说在爱买有买。	我打算去餐厅买牛肉，可是我不知道去哪里买，我听说在爱买有卖。
尤其是当握到非洲去时，体验穷人的生活，跟他们分享经验。	尤其是当我到非洲去时，体验穷人的生活，跟他们分享经验。
东西都有利有弊，网路虽然时我们的生活变得方便，但也有负面的影响。	东西都有利有弊，网路虽然使我们的生活变得方便，但也有负面的影响。
我希望你很快快复。	我希望你很快恢复。
我很喜欢那个地方，因为是我常大的地方。	我很喜欢那个地方，因为是我长大的地方。
我们都不知道最近您十吨跟么工厂的方法让臭味越来越重呢？您有没有港觉到阿！	我们都不知道最近您十吨跟么工厂的方法让臭味越来越重呢？您有没有感觉到啊！
对我来说要是我受伤也感冒也都没问题，我总是一定上课。可是如果我的血绿人出事的话，我不能上课。	对我来说要是我受伤也感冒也都没问题，我总是一定上课。可是如果我的血缘人出事的话，我不能上课。
我知道有的我们的我们的朋友可以跟你一起去，我可以帮你问他们澳是他们有空跟你一起去你要工作的地方。	我知道有的我们的我们的朋友可以跟你一起去，我可以帮你问他们要是他们有空跟你一起去你要工作的地方。
感谢你们寄给我的边请卡。	感谢你们寄给我的邀请卡。
老师很不高兴大明那么旧才来不让他进来。	老师很不高兴大明那么久才来不让他进来。
没有关系也看我的电视，免费！清等我回来。	没有关系也看我的电视，免费！请等我回来。
如果问题就在超级市场的责任的话，希望您和卫生局长会说服超市停片人家他们的采是有机的。	如果问题就在超级市场的责任的话，希望您和卫生局长会说服超市停骗人家他们的菜是有机的。
如果一方出现了怀疑的心态，就算令一方做的有多好也无法造就这个小孩将来的成功。	如果一方出现了怀疑的心态，就算另一方做的有多好也无法造就这个小孩将来的成功。
我们也有证明的质料给您思考，也得看您愿不愿意跟我们座谈。	我们也有证明的资料给您思考，也得看您愿不愿意跟我们座谈。
恭喜恭喜！你找到工作，我门也很高兴。	恭喜恭喜！你找到工作，我们也很高兴。
我们希望用好好的方法来互相研究，怎么时间美丽的生活环境。	我们希望用好好的方法来互相研究，怎么实践美丽的生活环境。
冷的时候人不太去外面，他们在家喝批具。	冷的时候人不太去外面，他们在家喝啤酒。
我们的附近地方不是开给工厂用的，而且我们打算去立法院抗议，这个问题有很大影到我们住进的生活平。	我们的附近地方不是开给工厂用的，而且我们打算去立法院抗议，这个问题有很大影到我们住进的生活品。
因你们公司工厂最近对我们造成非常大的影响，目前就是贵公司工厂的噪音和臭味都让我们另居都受不了，因此我们希望李厂长帮助我们处理一下。	因你们公司工厂最近对我们造成非常大的影响，目前就是贵公司工厂的噪音和臭味都让我们邻居都受不了，因此我们希望李厂长帮助我们处理一下。
以我看，类式这样的事情会经常发生的，尤其是在一些贫穷学生或留学生身上。	以我看，类似这样的事情会经常发生的，尤其是在一些贫穷学生或留学生身上。
大家应该找一棵大树可能修系吧。	大家应该找一棵大树可能休息吧。
由于网络世界的宜取得特性，造成许多青少年更加容易从网路上取得不良的资讯，例如色情网站等等。	由于网络世界的易取得特性，造成许多青少年更加容易从网路上取得不良的资讯，例如色情网站等等。
而且离您的工厂半经十公里以内有三千人，您一家工厂的噪音和味道都影响到这三千人的生活。	而且离您的工厂半径十公里以内有三千人，您一家工厂的噪音和味道都影响到这三千人的生活。
可是这个巴士来得时很慢，结果我来不起上课。	可是这个巴士来得时很慢，结果我来不及上课。
虽然我体凉妳这次经验让妳相当难过吧，可是妳一点都不必难过啦！	虽然我体谅妳这次经验让妳相当难过吧，可是妳一点都不必难过啦！
因为如果我们上网，著好的方面去学习是非常好的一件事。	因为如果我们上网，找好的方面去学习是非常好的一件事。
因为他们相信他们的小孩很乖不会向老师讲的话那么严重。	因为他们相信他们的小孩很乖不会像老师讲的话那么严重。
她是他的中文老师，他们都吃凉了。	她是他的中文老师，他们都吃惊了。
还有私立的学校老师会帮忙你的小孩如果他不了解今天的题目，老师会照顾小孩很像家里的感觉，我们学校设备多很好。	还有私立的学校老师会帮忙你的小孩如果他不了解今天的题目，老师会照顾小孩很像家里的感觉，我们学校设备都很好。
就像我们华人常听到「男主外，女主内」的句字。	就像我们华人常听到「男主外，女主内」的句子。
如果你缺钱的话你跟我说，我借给你或著我们想别的办法。	如果你缺钱的话你跟我说，我借给你或者我们想别的办法。
我们希望拰可以对大家早想，为大家的健康跟这边的空气希望你有改变的想法。	我们希望您可以对大家著想，为大家的健康跟这边的空气希望你有改变的想法。
他北老师骂他，所以马上去打工车上班。	他怕老师骂他，所以马上去搭公车上班。
同时你也相信老师的专业，能够处里教学过程中的种种问题。	同时你也相信老师的专业，能够处理教学过程中的种种问题。
他从半年前起，一直在医院里，可能她将来会没希望了。如果他死掉的，你能负责任吗？	他从半年前起，一直在医院里，可能她将来会没希望了。如果他死掉了，你能负责任吗？
从我得学校图书馆时数纪录卡里面来看，每个同学在网路室的时数高于阅读室三倍。	从我的学校图书馆时数纪录卡里面来看，每个同学在网路室的时数高于阅读室三倍。
我很高兴你们要请我参加你们的寰麟。	我很高兴你们邀请我参加你们的婚礼。
我门国家的天气只有两个季节：雨季与干季，如果你要来我建议你干季时来比较好。	我们国家的天气只有两个季节：雨季与干季，如果你要来我建议你干季时来比较好。
他说您好，可是老是说错，塔说学生影该说你好。	他说您好，可是老是说错，他说学生应该说你好。
当地居民（如花连居民）的意愿很正常，可以了解。因为谁都希望自己的生活变好。不过，如果因为要经济发展而牺牲这些美丽风景，我觉得不太值得去作。	当地居民（如花莲居民）的意愿很正常，可以了解。因为谁都希望自己的生活变好。不过，如果因为要经济发展而牺牲这些美丽风景，我觉得不太值得去做。
我跟他说：「你正在那里，为什么还没来，我等你等了半天了！」	我跟他说：「你正在哪里，为什么还没来，我等你等了半天了！」
我打算下个周末我跟你一起去台北动物园。	我打算下个周末我跟你一起去台北动物园。
他们要看得是美国电影。他们觉得很好看，所以他们看完了以后决定一定要买这个电影的ＤＶＤ了。	他们要看的是美国电影。他们觉得很好看，所以他们看完了以后决定一定要买这个电影的ＤＶＤ了。
我也会去新闻告诉他们您知道我们的文，你知道我们的苦难，可是你没做甚么。	我也会去新闻告诉他们您知道我们的问，你知道我们的苦难，可是你没做甚么。
他们花很多时间，任何事情多不管了，这件事情很严重了。	他们花很多时间，任何事情都不管了，这件事情很严重了。
我喜欢跟我的朋友一起去看电影，真喜欢看书，跳舞，唱歌，去陆行，和听音乐。	我喜欢跟我的朋友一起去看电影，真喜欢看书，跳舞，唱歌，去旅行，和听音乐。
我知道您是一位有学问的人因该知道怎么处理这件事，所以我不要多说了。	我知道您是一位有学问的人应该知道怎么处理这件事，所以我不要多说了。
小孩长大得很快，越来越有他们自己的世界，有时候要跟爸爸妈妈不能说的秘密。	小孩长大得很快，越来越有他们自己的世界，有时候有跟爸爸妈妈不能说的秘密。
只有不认真的人和把教室当成一个有玩的地方的人会心虚且反对安装摄影机的作法。	只有不认真的人和把教室当成一个有玩的地方的人会心虚且反对安装摄影机的做法。
我是您附近的邻区王大华。再说、我是一个代表所有的邻去给您写这封信。	我是您附近的邻居王大华。再说、我是一个代表所有的邻居给您写这封信。
我那样子玩大概两三个月，每一个礼拜根不一样的人出来玩，所以中文就慢慢的变成很好的都讲得很流利，还有因为常常在电脑聊天打子都打得很快，所以纳的时候很快乐。	我那样子玩大概两三个月，每一个礼拜跟不一样的人出来玩，所以中文就慢慢地变成很好的都讲得很流利，还有因为常常在电脑聊天打字都打得很快，所以那个时候很快乐。
像租狗这样的活动或多或小令人误会我们不需要有责任感。	像租狗这样的活动或多或少令人误会我们不需要有责任感。
洋娃娃和玩具已经被淘汰，成为电玩和手机了，但是父母不只不让孩子把手机留在家里去上课，而为了孩子的安全与方便就支持他们是用这种安全项目。	洋娃娃和玩具已经被淘汰，成为电玩和手机了，但是父母不只不让孩子把手机留在家里去上课，而为了孩子的安全与方便就支持他们使用这种安全项目。
那部很刺激，妳看过吗。好像叫「通激犯」，妳要是没看过，那天我们一起看看好吗？	那部很刺激，妳看过吗。好像叫「通缉犯」，妳要是没看过，哪天我们一起看看好吗？
现代社会的学生们大多数是早熟而且在经济方面也好，他们是信众带著很多渴望比如说有权力的学生很想行驶他们的权力，有钱的学生想像同学们炫耀他们的财富。	现代社会的学生们大多数是早熟而且在经济方面也好，他们是信众带著很多渴望比如说有权力的学生很想行使他们的权力，有钱的学生想向同学们炫耀他们的财富。
不管他们在学校学甚么，都公司里上班了。	不管他们在学校学甚么，都公司里上班了。
我身边的很多朋友们，也都受到经融风暴的影响，不是失去工作就是被要求「无薪假」。	我身边的很多朋友们，也都受到金融风暴的影响，不是失去工作就是被要求「无薪假」。
发生这种事情，我也替妳打包不平，老实说，我也曾经有这样不好的经验，所以你的心情我很能够体会，也很能了解。	发生这种事情，我也替妳打抱不平，老实说，我也曾经有这样不好的经验，所以你的心情我很能够体会，也很能了解。
我往这个方向走不但让家人可以骄傲的讲我的学位，也会让我们国家很骄傲有这么努力的一位国家代表。	我往这个方向走不但让家人可以骄傲地讲我的学位，也会让我们国家很骄傲有这么努力的一位国家代表。
我们可以积极找另外一份工作，使得我们的生活匆忙，人就是要匆忙的生活，才会有意义的，偶尔给自己放泄压力。	我们可以积极找另外一份工作，使得我们的生活匆忙，人就是要匆忙地生活，才会有意义的，偶尔给自己发泄压力。
别再喝酒太多。别再睡过头把！	别再喝酒太多。别再睡过头吧！
我真希望妳这次可以跟我忆起去。	我真希望妳这次可以跟我一起去。
但是这个事也完全不是不好，现在学生在学校常吵架、大家。	但是这个事也完全不是不好，现在学生在学校常吵架、打架。
因此除了小孩子的想法就变丰富，也有论理的思考。	因此除了小孩子的想法就变丰富，也有伦理的思考。
如果你真觉得受不了，请你刚快把你最重要的东西准备好，马上来台北找我！	如果你真觉得受不了，请你赶快把你最重要的东西准备好，马上来台北找我！
不好亿思！我建在不能去看你，因为我建在在美国跟我爸妈看我姊姊。	不好意思！我现在不能去看你，因为我现在在美国跟我爸妈看我姊姊。
台湾担心在花莲盖了高树公路就怕环境问题的事，但是为什么政府不想，如果交通好，经济会发达，而经济发达时我们可以有很多钱处里环境问题的事，这倒是不会很难的吧。	台湾担心在花莲盖了高速公路就怕环境问题的事，但是为什么政府不想，如果交通好，经济会发达，而经济发达时我们可以有很多钱处里环境问题的事，这倒是不会很难的吧。
「青少年上网得数多」的情况。	「青少年上网时数多」的情况。
机天个ㄇ他们说一说，先别告诉他们重要的消息像你们的电话号码，地址，你们的学校，什么的！	几天个ㄇ他们说一说，先别告诉他们重要的消息像你们的电话号码，地址，你们的学校，什么的！
不过，你还年轻，有电脑专长，中英日文都通，一定会有公司需要你这样的人材！	不过，你还年轻，有电脑专长，中英日文都通，一定会有公司需要你这样的人才！
我很期待他下一次会来看我。	我很期待她下一次会来看我。
回家的时候他们坐公车，张大林站著沾著，然后就问她。	回家的时候他们坐公车，张大林站著站著，然后就问她。
而且在我们班中，只有我跟她的关系最不好的。	而且在我们班中，只有我跟她的关系最不好的。
我们家呢，平常我妈妈会煮家常菜相：炒或烫青菜；煎或考鱼；烤鱼饼等等。	我们家呢，平常我妈妈会煮家常菜像：炒或烫青菜；煎或烤鱼；烤鱼饼等等。
因此如果有网站可以直接看学校的小孩，这些坏色人有新的机会抓到他们！	因此如果有网站可以直接看学校的小孩，这些坏的人有新的机会抓到他们！
从身上连一块钱都没有，慢慢地发展自己的事业，好不容易才有今天，在加上从小到大您照顾我们、这个家庭，不知道您得吃多少苦。	从身上连一块钱都没有，慢慢地发展自己的事业，好不容易才有今天，再加上从小到大您照顾我们、这个家庭，不知道您得吃多少苦。
听说你生病了，也不看到你上个。	听说你生病了，也不看到你上课。
那天的棒球比赛分数很接近，我们看了很经张，可是我们觉得很开心。	那天的棒球比赛分数很接近，我们看了很紧张，可是我们觉得很开心。
如果我们烤炉用网路来交朋友的原因，我们就看出为甚么那么多人喜欢这个选择。	如果我们考虑用网路来交朋友的原因，我们就看出为甚么那么多人喜欢这个选择。
你不让他检查的话，不止他会觉得你真的偷他的钱包，其他的朋友可能也会这样想。	你不让他检查的话，不只他会觉得你真的偷他的钱包，其他的朋友可能也会这样想。
我们的这个地球只能美丽如果万生万物都不段生殖发展。	我们的这个地球只能美丽如果万生万物都不断生殖发展。
请想像一位未来总统候选人；如果媒体捉去她小时候影片，发现甚么缺点，就算是小时候，选民必然会受不好的影像。	请想像一位未来总统候选人；如果媒体捉去她小时候影片，发现甚么缺点，就算是小时候，选民必然会受不好的影响。
虽然经济的崛起，带动了科技的运用但是不是每个情况都可以把科技运动得到。	虽然经济的崛起，带动了科技的运用但是不是每个情况都可以把科技运用得当。
这样将来经营这家公司的话，我自己也会有信心的经营它。	这样将来经营这家公司的话，我自己也会有信心地经营它。
而且我觉得我的知识还不足我还要学习各各方面的。	而且我觉得我的知识还不足我还要学习各个方面的。
不过我行新你是个懂得道理、也是个优质是人才，所以你该栋我所说的话吧！	不过我相信你是个懂得道理、也是个有知识人才，所以你该懂我所说的话吧！
他要等十五分种，但是车都还没到，所以他开跑。	他要等十五分钟，但是车都还没到，所以他开跑。
我的家是在您的工厂附近，最近您的工厂得噪音和臭味都让这里的人民真受不了。	我的家是在您的工厂附近，最近您的工厂的噪音和臭味都让这里的人民真受不了。
我要跟你们说恭喜恭喜，我希望你门想要的东西都可以拿得到。	我要跟你们说恭喜恭喜，我希望你们想要的东西都可以拿得到。
儒家的传统思想，养不教父子过、教不严师之惰。所以造成读书风气的甚行、只要认真努力、没有做不到的事	儒家的传统思想，养不教父之过、教不严师之惰。所以造成读书风气的盛行、只要认真努力、没有做不到的事
如果你又要去的话，你在跟我联络。	如果你有要去的话，你再跟我联络。
这城市很少对不对？	这城市很小对不对？
用个人来说很明确得回答该是什么是「对」都要看人，但是根据我的经验比较要看社会的传统观念。	用个人来说很明确的回答该是什么是「对」都要看人，但是根据我的经验比较要看社会的传统观念。
我跟你说如果枣果你的能力干最分手就好。	我跟你说如果超过你的能力干脆分手就好。
我小时后也有电脑用了，它让我学了很多见识在网路上。	我小时候也有电脑用了，它让我学了很多见识在网路上。
随时知道小孩的状况，也了解老师上课的情行。	随时知道小孩的状况，也了解老师上课的情形。
大明紧张得不的了，因为怕被老师骂。	大明紧张得不得了，因为怕被老师骂。
电影真的不错，可是美美睡了半个小时，所以内容懂不清楚。	电影真的不错，可是美美睡了半个小时，所以内容都不清楚。
凡事训利。	凡事顺利。
明天是我的生日，所以我们要去餐订吃饭。	明天是我的生日，所以我们要去餐厅吃饭。
他真的很胡涂，因为他还不会说中文。	他真的很糊涂，因为他还不会说中文。
你有空的话我请你吃，好不好？这样子我们就可以便聊天便骂李坏蛋。	你有空的话我请你吃，好不好？这样子我们就可以边聊天边骂李坏蛋。
因为这里附近的人已经反应很久了、为了我们居友感情、你身为工厂的长厂、希望你会好好的处理、让这里的人有一些美好的日子、不会因为工厂的影响而造成困扰。	因为这里附近的人已经反应很久了、为了我们居友感情、你身为工厂的厂长、希望你会好好的处理、让这里的人有一些美好的日子、不会因为工厂的影响而造成困扰。
几年前，在有一个小学，女孩子杀他的同学。因为他在ＢＢＳ骂她，她请他在不做，但是他不停，她受不了杀同学。	几年前，在有一个小学，女孩子杀她的同学。因为她在ＢＢＳ骂她，她请她再不做，但是她不停，她受不了杀同学。
在一个教室里有很多小孩、老是教他们或讲他们不听话、老师跟家长讲有的聊解自己的小孩就会聊解老师的话、相反有的家长步踏聊解自己的小孩一定不会聊解老师说的。	在一个教室里有很多小孩、老师教他们或讲他们不听话、老师跟家长讲有的了解自己的小孩就会了解老师的话、相反有的家长不太了解自己的小孩一定不会聊解老师说的。
根据医院的检查证据与我们全家人所遭遇的事物中毒，一出院，我和我弟弟到了大明超市场想跟那边的管理员抗议。	根据医院的检查证据与我们全家人所遭遇的食物中毒，一出院，我和我弟弟到了大明超市场想跟那边的管理员抗议。
你的回答我受到了，谢谢。	你的回答我收到了，谢谢。
闹钟响了好几次也无法叫醒他，结果他七点二十五分才陪吵醒来。	闹钟响了好几次也无法叫醒他，结果他七点二十五分才被吵醒来。
在中午，天气很日，日子过得很快，我一点著急。	在中午，天气很热，日子过得很快，我一点著急。
下课以后我跟朋友一起座公车，我们看电影。	下课以后我跟朋友一起坐公车，我们看电影。
你觉得在学校学生被家人看得时候他们的感觉怎么样？一定很紧张。	你觉得在学校学生被家人看的时候他们的感觉怎么样？一定很紧张。
如果这两件是慢慢累积起来会影响到大家的健康和工作精神更不用说小朋友们的功课了。	如果这两件事慢慢累积起来会影响到大家的健康和工作精神更不用说小朋友们的功课了。
所以我希望厂长有怎么方法可能帮我解决这问题，让环境改变好一点，大家生活快乐健康不担心。	所以我希望厂长有什么方法可能帮我解决这问题，让环境改变好一点，大家生活快乐健康不担心。
我也很喜欢我的国家，因为我觉得德国的文化真别只。	我也很喜欢我的国家，因为我觉得德国的文化真别致。
我也曾经有跟你类似的经验，当时，我真得很难过。	我也曾经有跟你类似的经验，当时，我真的很难过。
再加上在工作的地方有机会见面别的人，也可以学习新的文，最后经验越来越多。职业女生会增加她们的新智。	再加上在工作的地方有机会见面别的人，也可以学习新的文，最后经验越来越多。职业女生会增加她们的心智。
那么我们身上碰到的空气赃的没有那么利害。为身么这么好出的东西为了小小的东西要弄掉呢？	那么我们身上碰到的空气脏的没有那么厉害。为什么这么好出的东西为了小小的东西要弄掉呢？
如果我们可以去两个里拜，就一锭很好玩！	如果我们可以去两个礼拜，就一定很好玩！
越来越多人都是靠网路来过生活的，没有了网路就好像没了生命史的。	越来越多人都是靠网路来过生活的，没有了网路就好像没了生命似的。
李大年十一个坏蛋不要再找他、不要帮他任何忙。	李大年是一个坏蛋不要再找他、不要帮他任何忙。
时间已经过了好久，书没读，作业也没做，而聊天也没有得到什么收获，就这样白白的把宝贵的时间送走了。	时间已经过了好久，书没读，作业也没做，而聊天也没有得到什么收获，就这样白白地把宝贵的时间送走了。
请老师给我一天休息时间，我会上课如果身提好了。	请老师给我一天休息时间，我会上课如果身体好了。
我知道你的意思，除了目前的生活很痛苦意外，你也许那我一个主意。	我知道你的意思，除了目前的生活很痛苦以外，你也许那我一个主意。
一年以后我要回家因为我再波兰要找工作。	一年以后我要回家因为我在波兰要找工作。
我还是年研究生，所以我想要经验很多事情，而且我想交世界各地的朋友。	我还是念研究生，所以我想要经验很多事情，而且我想交世界各地的朋友。
所以去者里抗议这件事情，但是他们不听我的话，而且让我被挡在门外。	所以去这里抗议这件事情，但是他们不听我的话，而且让我被挡在门外。
你也别怪她吧，也许他回家后自己心理会很尴尬。	你也别怪她吧，也许他回家后自己心里会很尴尬。
他跟那位小姐道谢，就杆快去上课。	他跟那位小姐道谢，就赶快去上课。
如果没有这个高速公路，不仅很多外地人没有机会到花莲享受那边的大自然，本地人也没有机会与资源开始环境保护的工作，只能靠利用大自认的资源生活，然而破坏环境。	如果没有这个高速公路，不仅很多外地人没有机会到花莲享受那边的大自然，本地人也没有机会与资源开始环境保护的工作，只能靠利用大自然的资源生活，然而破坏环境。
这次的全球经济衰退，对我来说也有影响，使得新水减少、工作天数变少等。	这次的全球经济衰退，对我来说也有影响，使得薪水减少、工作天数变少等。
我觉得你高心得不得了。	我觉得你高兴得不得了。
我要吃日本蔡。	我要吃日本菜。
那一天我回想妳们所以我跟你们会打电话！	那一天我会想你们所以我跟你们会打电话！
他们玩得很高兴，小王回来的时候就觉得很来，所以他洗澡了就去学教。	他们玩得很高兴，小王回来的时候就觉得很累，所以他洗澡了就去睡觉。
因为他们知道父母请看得到他们的动作，会让孩子比较认真，对他们读书或上课好。	因为他们知道父母亲看得到他们的动作，会让孩子比较认真，对他们读书或上课好。
我来界上一下。	我来介绍一下。
后来一般工作一般找很满意的。结果我才找到现在的工作。	后来一边工作一边找很满意的。结果我才找到现在的工作。
但我最近由于我毕业的程序要办很多杂事，故一值都很忙碌，恐怕我没有时间可以过去看看。	但我最近由于我毕业的程序要办很多杂事，故一直都很忙碌，恐怕我没有时间可以过去看看。
王大华带他的与沙，他的努儿报纸。	王大华带他的雨伞，他的女儿报纸。
因为天气很好，所以他打算去录行。	因为天气很好，所以他打算去旅行。
下天早上她的朋友请她去路行，他们照很多像片。	下天早上她的朋友请她去旅行，他们照很多相片。
印尼有一个地方叫巴黎，那边的风景最好看的。	印尼有一个地方叫峇里，那边的风景最好看的。
若青少年以尊守这种规定来使用的话，应该可以好好地利用。	若青少年以遵守这种规定来使用的话，应该可以好好地利用。
「家张限制青少年上网时数」的话题？我非常支持！	「家长限制青少年上网时数」的话题？我非常支持！
老板告诉王大华帮你点蔡。	老板告诉王大华帮你点菜。
不要这件事情已怀在心理，或对那位诬赖你的人怀恨在心，你就当作是人都会有他失误的时候。	不要这件事情已怀在心里，或对那位诬赖你的人怀恨在心，你就当作是人都会有他失误的时候。
一旦发现家庭教育和学校教育的理念有差意，他们会朝著对自己有利的方向发展，导致学校和家庭的教育严重的冲突。	一旦发现家庭教育和学校教育的理念有差异，他们会朝著对自己有利的方向发展，导致学校和家庭的教育严重的冲突。
台湾没有美国的那么大，所以台湾人更需要小心得发展。	台湾没有美国的那么大，所以台湾人更需要小心地发展。
义务教育必须治基本人权的范围内。不仅学生而老师也有权利对别人确保自已生活包括教育中生活。	义务教育必须在基本人权的范围内。不仅学生而老师也有权利对别人确保自己生活包括教育中生活。
所以我还是会慢慢的放宽我对我女儿的电脑使用，但是我支持「家长限制青少年的上网时数」。	所以我还是会慢慢地放宽我对我女儿的电脑使用，但是我支持「家长限制青少年的上网时数」。
因为这个题目对他来说不难，没几分钟她已经就烤好了。	因为这个题目对他来说不难，没几分钟他已经就考好了。
他应该先仔细回想自己到底把钱包放在那里。不应该茂茂然说你偷了他的钱包。	他应该先仔细回想自己到底把钱包放在那里。不应该冒冒然说你偷了他的钱包。
如果有工作的话，女生可能会感觉到自己是社会的一个团员，给社会有所贡献。在加上给家庭经济上的安定与繁荣。	如果有工作的话，女生可能会感觉到自己是社会的一个团员，给社会有所贡献。再加上给家庭经济上的安定与繁荣。
网路交友绝对是一件从满人文的事情，我们只要真心真意向人家交往，人家也一定会无居心与我们相处。	网路交友绝对是一件充满人文的事情，我们只要真心真意向人家交往，人家也一定会无居心与我们相处。
尤其是刚刚说到的猪脚。怎么作，我也不太清楚。	尤其是刚刚说到的猪脚。怎么做，我也不太清楚。
听说在新竹的科技业，收到经济不经济的影响，很多大公司实施了这样的正策。	听说在新竹的科技业，受到经济不经济的影响，很多大公司实施了这样的政策。
女人结婚生子以后，应该继续工作当个职业妇女，不应该只再家当个家庭主妇，专心照顾先生，孩子。	女人结婚生子以后，应该继续工作当个职业妇女，不应该只在家当个家庭主妇，专心照顾先生，孩子。
其是碰到困难的时候同学总是请他帮他们写功课，下课以后常常把学校的事一起讨论。	其实碰到困难的时候同学总是请他帮他们写功课，下课以后常常把学校的事一起讨论。
可是春天跟秋天的风景票漂亮亮的，春天可以看看开花。	可是春天跟秋天的风景漂漂亮亮的，春天可以看看开花。
小王对不气，我明天不可以跟你去看电影。	小王对不起，我明天不可以跟你去看电影。
他座公车三十分钟才到学校了。	他坐公车三十分钟才到学校了。
我刚才受到你的信。根据你的信我知道你在遇见很大的事情。	我刚才收到你的信。根据你的信我知道你在遇见很大的事情。
在休息的时候我又吃一点点心又和一点饮料。	在休息的时候我又吃一点点心又喝一点饮料。
我仅请贵局应为消费者做出行动，对此事进行调查，严格的处理此事，给消费者讨个公道同时以免后来此事再次发生。	我敬请贵局应为消费者做出行动，对此事进行调查，严格地处理此事，给消费者讨个公道同时以免后来此事再次发生。
妈妈不会说中文，而且他不要一个人在家里。	妈妈不会说中文，而且她不要一个人在家里。
我想拿出来一些啤酒，一些平干。	我想拿出来一些啤酒，一些饼干。
我们跳无完的以后，就回家了。	我们跳舞完的以后，就回家了。
今天王上我要跟你很重要的事情谈一谈。	今天晚上我要跟你很重要的事情谈一谈。
李大明因为昨日认真复习，所以面对考试的时候他很有信心，而且很准时的交卷。	李大明因为昨日认真复习，所以面对考试的时候他很有信心，而且很准时地交卷。
今天大华上课老师告诉同学明天考试，交同学会去准备复习第一课到第三课。	今天大华上课老师告诉同学明天考试，叫同学回去准备复习第一课到第三课。
开车的人听了他的华马上说：「我可以用我的车陪你去，好不好？」	开车的人听了他的话马上说：「我可以用我的车陪你去，好不好？」
毕业找高薪的工作常常是不得已的，不然怎们能还清借来的学费。	毕业找高薪的工作常常是不得已的，不然怎么能还清借来的学费。
我们喜望请你赶快处理以上的问题，我们要求下个月以内把那问题解决。	我们希望请你赶快处理以上的问题，我们要求下个月以内把那问题解决。
每每要看外国电影，所以文德买票给她。	美美要看外国电影，所以文德买票给她。
第一个是跟生音有问题、第二个是跟味道有问题。	第一个是跟声音有问题、第二个是跟味道有问题。
我建议你多活用现在你有的三天得放假的时间，比如说，你趁著这些时间可以去学电脑、外语、商业等。	我建议你多活用现在你有的三天的放假的时间，比如说，你趁著这些时间可以去学电脑、外语、商业等。
这样的方法除了办父母亲了解，安心朋友上课的状况还有另外的帮助是使得不专心上课的小朋友怕父母亲知道而认真学习。	这样的方法除了帮父母亲了解，安心朋友上课的状况还有另外的帮助是使得不专心上课的小朋友怕父母亲知道而认真学习。
第一，卖受到的钱可以利用过轻轻松松的日子，你不会担心钱的问题。	第一，卖收到的钱可以利用过轻轻松松的日子，你不会担心钱的问题。
其实受到你的信我也觉得很高兴了。	其实收到你的信我也觉得很高兴了。
最近也发生了不少青年应上网时数超多，造成死亡。	最近也发生了不少青年因上网时数超多，造成死亡。
毕竟，如果你跟你的这个朋友再提出这个问题，说不定会边得更严重。	毕竟，如果你跟你的这个朋友再提出这个问题，说不定会变得更严重。
真是德国是盲羊补牢的行为。台湾决不重蹈德国的辅辙。那一定要挣救台湾的宝𫞥。	真是德国是亡羊补牢的行为。台湾绝不重蹈德国的覆辙。那一定要拯救台湾的宝贝。
是因为最近您的工厂的噪音和臭味都让林区受不了了。所以我们提出如下一个建议让您想想看。	是因为最近您的工厂的噪音和臭味都让邻居受不了了。所以我们提出如下一个建议让您想想看。
最近我正在筹备我的生日会，我准备了很多节目，还有你喜欢的蛋糕，到时后你记得来参加。	最近我正在筹备我的生日会，我准备了很多节目，还有你喜欢的蛋糕，到时候你记得来参加。
这里附近你心里也知道有好多少人在你工厂附近，他们都回收到影响。	这里附近你心里也知道有好多少人在你工厂附近，他们都会受到影响。
我从我的家去捷运站，座捷运到了捷运古亭站，我迷路了因为我选不对的出口出去。	我从我的家去捷运站，坐捷运到了捷运古亭站，我迷路了因为我选不对的出口出去。
上课的时候，张爱文问林美美下个以后要不要跟他一起去看电影。	上课的时候，张爱文问林美美下课以后要不要跟他一起去看电影。
不要紧，美英，我相信妳觉对不是那种会偷别人东西的人。	不要紧，美英，我相信妳绝对不是那种会偷别人东西的人。
我们知道你们没帮法不发声音，可是我们希望现在的噪音比未来的噪音小。	我们知道你们没办法不发声音，可是我们希望现在的噪音比未来的噪音小。
另外我们还可以制作海报把它贴在学校的交谊厅里。	另外我们还可以制作海报把它贴在学校的交谊厅里。
结果，前夫从外面透进来本校，在教室里杀了她。	结果，前夫从外面偷进来本校，在教室里杀了她。
她恨票亮，到晚上我请他先吃饭，在去玩。	她很漂亮，到晚上我请他先吃饭，再去玩。
做父母的人比较容易管理他们的孩子，有些孩子往往娇课。	做父母的人比较容易管理他们的孩子，有些孩子往往翘课。
除了青少年一万跟我一样的成人也正在受到上网的很多优惠。	除了青少年以外跟我一样的成人也正在受到上网的很多优惠。
放这个机在教室里面也可以帮校长了解孩子还有什么需要还没却到，也能帮学校安排比较有用和有意思的课程。	放这个机在教室里面也可以帮校长了解孩子还有什么需要还没学到，也能帮学校安排比较有用和有意思的课程。
我支持校厂的决定，教室里该装摄影机。	我支持校长的决定，教室里该装摄影机。
从古以来女人结婚后就在家里照顾丈夫和孩子、做家事甚么的，而男人必须到外面去、工作赚钱养家，优其是亚洲人的国家。	从古以来女人结婚后就在家里照顾丈夫和孩子、做家事甚么的，而男人必须到外面去、工作赚钱养家，尤其是亚洲人的国家。
我下此暑假打算回家，到时候我们再好好讨论。	我下次暑假打算回家，到时候我们再好好讨论。
可能政府会决定你们可以般到别的地方，还有可能会给你们更多钱。	可能政府会决定你们可以搬到别的地方，还有可能会给你们更多钱。
您门好希望都没问题，我们有一些事情要告诉您们希望您们了解我的意思。	您们好希望都没问题，我们有一些事情要告诉您们希望您们了解我的意思。
可是也是因为有了这么方便的机器，让我再写功课时没办法很专心。	可是也是因为有了这么方便的机器，让我在写功课时没办法很专心。
那昨天的功课，超１０个句子我只好明天交给你。	那昨天的功课，抄１０个句子我只好明天交给你。
我怕她这几天可能会过世，因此我计划下礼拜去密鲁探亲。	我怕她这几天可能会过世，因此我计划下礼拜去秘鲁探亲。
他虽然还没学过一点中文，可是很永敢的一个人去台湾。	他虽然还没学过一点中文，可是很勇敢的一个人去台湾。
这几天，我们的邻区一个一个地来跟我烦恼。	这几天，我们的邻居一个一个地来跟我烦恼。
只有女人能生孩子。所以男人和社会应该办助女人。我们应该办助孕妇的职业妇女。也应该办助有孩子的职业妇女。	只有女人能生孩子。所以男人和社会应该帮助女人。我们应该帮助孕妇的职业妇女。也应该办助有孩子的职业妇女。
随者电脑的普及化，生活也越来越便利化，人们不只可以快速地获得资讯，并且可以跟各地的人交流。	随著电脑的普及化，生活也越来越便利化，人们不只可以快速地获得资讯，并且可以跟各地的人交流。
本来我打算去你的公司参加，可是后来我的家有问题，所以我不能去了。	本来我打算去你的公司参加，可是后来我的家有问题，所以我不能去了。
在花莲县去年一位特殊的高中生因未收到老师的色情暴力怀孕，那件事造成连学长格致。	在花莲县去年一位特殊的高中生因为受到老师的色情暴力怀孕，那件事造成连学长革职。
目前在越南的经济正在发展中，人民经济能力提升，所以青少年有机会接触电脑越来越多了。很多电脑网路店展开的迅速惊人。	目前在越南的经济正在发展中，人民经济能力提升，所以青少年有机会接触电脑越来越多了。很多电脑网路店展开得迅速惊人。
传家说父母与孩子们建立好关系基础的最重要时期是孩子五到十二岁的时间。	专家说父母与孩子们建立好关系基础的最重要时期是孩子五到十二岁的时间。
我们发现您的工厂有很大的生音和臭味，大家都受不了。	我们发现您的工厂有很大的声音和臭味，大家都受不了。
例如选班上的干部时，我志愿当卫生组长。	例如选班上的干部时，我自愿当卫生组长。
可是我们在做菜天气下雨，我们戴东西到饭馆儿。	可是我们在做菜天气下雨，我们带东西到饭馆儿。
希望针对您工厂最近发生的一些问题找出处里方法以能够为居民们营造出优良的生活还境。	希望针对您工厂最近发生的一些问题找出处理方法以能够为居民们营造出优良的生活环境。
下了课以后，他跟文美常常见面。应为文美是他的好朋友。	下了课以后，他跟文美常常见面。因为文美是他的好朋友。
我希望可能参加你的晚会，可是他的生体真的不太好！	我希望可能参加你的晚会，可是他的身体真的不太好！
你找到你最喜欢的工作，我也很高心。	你找到你最喜欢的工作，我也很高兴。
但是，坦白的说我也是因为大家的生活与健康才不得已舆老板说。	但是，坦白的说我也是因为大家的生活与健康才不得已与老板说。
我是代表贵工厂附近的居民，王天华。今天写信表达居民对工厂的苦诉。	我是代表贵工厂附近的居民，王天华。今天写信表达居民对工厂的控诉。
